English	Spanish	Spanish verb
the student accounted for his absence	el estudiante justificó su ausencia	justificar
the student accounted for the loss of the book.	el estudiante explicó la pérdida del libro	explicar
the thief accounted for the missing money	el ladrón daba cuenta del dinero perdido	dar cuenta de
the book acts as an example	el libro sirve de ejemplo	servir de
the man acts as a manager 	el hombre hace de director 	hacer de
a lawyer acts for the client	un abogado representa al cliente	representar a
the state acted on the evidence	el estado reaccionó ante las pruebas	reaccionar ante
the drug acted on the immune system	el medicamento actuó sobre el sistema inmunitario	actuar sobre
the governor acted on the advice of the prime minister	el gobernador respondió al consejo del primer ministro	responder a
the actors acted out the characters	los actores representaron a los personajes	representar a
the actors act out their performances	los actores interpretan sus representaciones	interpretar
the tired child acted out	el niño cansado se comportó mal, el niño cansado se portó mal	comportar se mal, portar se mal
the tired child acted up	el niño cansado se comportó mal	comportar se mal
toddlers act up a lot	los bebes mayores se enrabietan mucho	enrabietar se
the priest cannot act upon his faith	el cura puede actuar por su fe	actuar por
the machines act upon the traditional mechanisms	las maquinas actúan sobre los mecanismos tradicionales	actuar sobre
the angles of a triangle add up to 180 degrees	los ángulos de un triángulo suman 180 grados	sumar
this strategy adds up to a sustainable world	esta estrategia lleva a un mundo sostenible, esta estrategia conduce a un mundo sostenible	llevar a, conducir a
the accounts add up well	las cuentas suman bien	sumar
the results add up	los resultados tienen sentido	tener sentido
the citizens adhere to the law	los ciudadanos acatan la ley	acatar
the students adhere to the school rules	los estudiantes obedecen las normas del colegio	obedecer
the worker adhered to the established conditions	el trabajador cumplió con las condiciones establecidas	cumplir con
the doctor advised against smoking	el medico aconsejó no fumar 	aconsejar no
the authorities advise against swimming in the sea	los autoridades desaconsejan nadar en el mar	desaconsejar
the girl agrees with the manager	la chica coincide con el director	coincidir con
the manager agrees with you	el director está de acuerdo contigo	estar de acuerdo con
the film is aimed at a young audience	la película se dirige a una audiencia joven	dirigir se a
the design allows for ground movement	el diseño tiene en cuenta el movimiento del suelo	tener en cuenta
the size does not allow for any expansion	el tamaño no permite ninguna ampliación	permitir
the text alludes to historical references	el texto alude a referencias históricas	aludir a
don’t answer your mother back	no le repliques a tu mamá	replicar a
the man answered back to the allegations	el hombre se defendió de las acusaciones	defender se de
his lawyer answers for the defendant	su abogado responde por el acusado	responder por
medical treatment is the answer for your problem	un tratamiento médico se adecúa a tu problema 	adecuar se a
the government appeals for assistance	el gobierno reclama asistencia, el gobierno solicita asistencia, el gobierno pide asistencia 	reclamar, solicitar, pedir
the queen appealed for the sovereign	la reina recurrió al soberano	recurrir a
the woman applies to the company	la mujer se presentó a la empresa	presentar se a
the politician applies to the new post	el político se postula al cargo nuevo	postular se a
the manager asked about the new hotel	el director preguntó por el hotel nuevo, el director preguntó sobre el hotel nuevo	preguntar por, preguntar sobre
the principal asked after the girl’s studies	el director preguntó por los estudios de la chica	preguntar por
the worker decided to ask around his colleagues	el trabajador decidió tantear a sus colegas	tantear a
the girl asked for a coffee	la chica pidió un café	pedir 
the boy asked for a response	el chico solicitó una respuesta	solicitar
the teacher asked for the boy’s name	el profesor preguntó por el nombre del chico	preguntar por
the man asked the woman in	el hombre invitó a entrar a la mujer	invitar a entrar a
the boss asked the workers in to the meeting room	el jefe invitó a pasar a los trabajadores a la sala de reuniones 	invitar a pasar a
the woman asked the handsome man out	la mujer invitó a salir al hombre guapo	invitar a salir a
the boss asked the worker out	el jefe mandó salir al trabajador	mandar salir a
the woman asked the man up to her apartment	la mujer invitó a subir al hombre a su piso	invitar a subir a
the teenager associates with criminals	el adolescente se junta con criminales	juntar se con
the student associates with idiots	el estudiante va con los tontos	ir con
the girl only associates with the popular kids	la niña solo anda con los niños guays	andar con
the private bank deals with rich clients	el banco privado trata con los clientes ricos	tratar con
the rope was attached to the gate	la cuerda estaba atada a la puerta	atar a
the participants attached peace ribbons to the wall	los participantes colocaron cintas de paz en la pared	colocar en
the scientist attached all the straps to the object	el científico ató todas las tiras al objeto 	abrochar a
the cable was attached to the monitor	el cable estaba conectado al monitor	conectar a
the dressmaker attached the sleeves to the dress	la modista sujetó la manga al vestido 	sujetar a
the nanny was attached to the boy	la niñera se encariñó con el niño	encariñar se con
the manager attaches importance to the following point	el director concedió importancia al siguiente punto	conceder a
the parents attended to the baby’s needs	los padres prestaron atención a las necesidades del bebé	prestar atención a
the child attends to his mother with particular devotion	el niño se ocupa de su mamá con especial devoción 	ocupar se de
the teacher attends to the student’s special needs	el profesor atiende a las necesidades especiales del alumno	atender a
the celebrity will auction off the classic car	el famoso subastará el coche clásico	subastar
the judge auctioned off the debtor’s belongings	el juez subastó remató las pertenencias del deudor 	rematar
the price averages out at 6.5 percent	el precio tiene una media de 6,5 por ciento	tener una media de
the criminals backed away when they saw the police	los criminales retrocedieron cuando vieron a la policía	retroceder
the explorer backed away when he saw the fierce animal	el explorador se retiró cuando vio el animal feroz	retirar se
the policeman backed away from the bomb	el policía se alejó de la bomba	alejar se de
the politician backed down immediately	el político reculó enseguida 	recular
the fighter is not going to back down again	el luchador no va a retroceder otra vez	retroceder
politicians often back out of electoral promises	los politicos se retractan de sus promesas electorales a menudo	retractar se de
the UN backed out of the negotiations	la ONU se volvió atrás en las negociaciones	volver se atrás en
the trade union backed out of negotiations the first day	el sindicato se echó atrás en las negociaciones el primer día	echar se atrás en
the employee backed out of the contract the next day	el empleado se desvinculó del contrato al día siguiente	desvincular se  de
the university backed out of the European project 	la universidad se retiró del proyecto europeo	retirar se de
the guest backed out of the event due to illness	el invitado se retiró del evento debido a una enfermedad 	retirar se de
the client backed out of the agreement	el cliente se retractó del acuerdo	retractar se de
the client backed out of the contract	el cliente se arrepintió del contrato	arrepentir se de
the man backed out of the romantic date	el hombre se echó atrás en la cita romántica	echar se atrás en
the scientist backed out of the research project 	el científico se retiró del proyecto de investigación	retirar se de
the company director backed up my sister	el director de la empresa respaldó a mi hermana, el director de la empresa apoyó a mi hermana	respaldar a, apoyar a
the boyfriend backs up the girl every day	el novio respalda a la chica todos los días	respaldar a 
thanks for backing up the idea	gracias por apoyar la idea	apoyar
back up the document please	realiza una copia de seguridad del documento por favor	realizar una copia de seguridad
people back up your idea	la gente respalda tu idea, la gente confirma tu idea, la gente corrobora tu idea	respaldar, confirmar, corroborar
the driver backed up the driveway	el conductor dio marcha atrás en la calzada	dar marcha atrás
the man backed up a little	el hombre retrocedió un poco	retroceder
the friends bailed out of the party	los amigos se retiraron de la fiesta	retirar se de
the girl bailed out at the last minute	la chica se rajó en el último momento	rajar se
the government bailed out the bank	el gobierno rescató el banco	rescatar
friends bailed him out the next day	los amigos le pagaron la fianza al día siguiente	pagar la fianza
the government bailed out the financial sector	el gobierno sacó al sector financiero de un apuro	sacar de un apuro a
the miners bailed the water out of the mines	los mineros achicaron el agua de las minas	achicar de
the company bailed out of the project	la empresa abandonó el proyecto, la empresa dejó el proyecto, la empresa se largó del proyecto	abandonar, dejar, largar se de
thee man bailed out of the project quickly	el hombre acabó con el proyecto pronto	acabar con 
the teacher banks on the student’s help today	la profesora cuenta con la ayuda del estudiante hoy	contar con
the film is based on a true story	la película se basa en una historia real	basar se en
the lecturer is about the faculty tomorrow	el profesor está por la facultad mañana	estar por
the boy is about five minutes from the school	el niño está más o menos a cinco minutos del colegio, el niño está aproximadamente a cinco minutos del colegio, el niño está a unos cinco minutos del colegio	estar más o menos a, estar aproximadamente a, estar a unos 
the boss was about yesterday	el jefe estuvo presente ayer	estar presente
the teacher is about tomorrow	el profesor está cerca mañana	estar cerca
the president was away last week	el presidente estuvo fuera la semana pasada	estar fuera
the people were back yesterday	la gente regresó ayer	regresar
the supervisor was back in the office yesterday	el supervisor volvió al despacho ayer	volver a
ths student went off to school	el estudiante se fue al colegio	ir se a
the results bear on the implementation of the new rules	sus resultados pesan sobre la implementación de las nuevas reglas	pesar sobre
these observations bear out the report's basic idea 	Estas observaciones confirman la idea básica del informe. 	confirmar
these figures bear out the results	Estas cifras corroboran los resultados	corroborar
the statistics do not bear out the first explanation 	las estadísticas no apoyan la primera explicación 	apoyar
a group of young people beat the boy up	un grupo de jóvenes aporreó al chico	aporrear a
the criminals beat the boy up last night	los criminales apalearon al chico anoche	apalear a
the boy beat up another child	el chico golpeó a otro niño	golpear a
the man beat up his wife a lot	el hombre pegó a su mujer mucho	pegar a
what became of your son?	¿Qué pasará pasó con tu hijo?	pasar con
nothing good will become of the boy now	nada bueno será del chico ahora	ser de
the FBI beefed up security at the White House	el FBI fortaleció la seguridad en la Casa Blanca	fortalecer
the girl bent down	la niña se agachó	agachar se 
the girl bent over	la niña se inclinó, la niña se agachó	inclinar se, agachar se 
a boy bent the piece of paper over	un niño dobló el papel	doblar
the man bet on his favourite horse	el hombre apostó por su caballo favorito	apostar por
the boy bit off more than necessary	el niño mordió más de lo necesario	morder
the power failure blacked out the area	el corte de energía oscureció el área 	oscurecer
the victim blacked out after the accident	la víctima se desmayó después del accidente	desmayar se
the gunman blew away a policeman	el pistolero liquidó a un policía, el pistolero mató a un policía	liquidar a, matar a
the candidate blew the interviewer away 	el candidato se metió en el bolsillo a la entrevistadora	meter se en el bolsillo a = blew away?
my papers blew away	mis papeles volaron	volar
the wind blew away the rain	el viento se llevó la lluvia	llevar se
the singer blew the audience away	el cantante deslumbró al público	deslumbrar a
the wind blew down many trees	el viento derrumbó muchos arboles, el viento derribó muchos arboles, el viento tumbó muchos arboles	derrumbar, derribar, tumbar
the wind blew down a tree in the city centre	el viento volteó un árbol en el centro de la ciudad	voltear
the singer’s voice blew the audience away	la voz del cantante dejó a la audiencia sin palabras	dejar sin palabras a
the boy’s secret blew the class away	el secreto del chico dejó a la clase de una pieza	dejar de una pieza a
the celebrity’s attitude blew the public down	la actitud del famoso dejó sin palabras al público	dejar sin palabras a
the man’s secret blew the audience down	el secreto del hombre sorprendió a la audiencia	sorprender a
a landmine blew off the victim’s leg	una mina terrestre voló una pierna de la víctima   	volar de
the dog blew off	el perro se tiró un pedo, el perro se echó un pedo	tirar se un pedo, echar se un pedo
the man blew off his friend’s birthday party	el hombre rechazó el cumpleaños de su amigo	rechazar
the girl blew off the doctors appointment yesterday	la chica faltó a la cita médica ayer	faltar a
the students blows off his homework everyday	el estudiante se escaquea de sus deberes todos los días	escaquear se de
the children blew out the candles	los niños apagaron las velas, los niños soplaron las velas	apagar, soplar 
the blast blew out all the windows	la explosión destrozó las ventanas	destrozar
a strong wind blew out the flames	un fuerte viento apagó las llamas	apagar
he blew out the party for an extra day of holidays	rechazó la fiesta por un día más de vacaciones	rechazar
the man saw the Hindenburg blow up	el hombre vio al Hindenburg volar por los aires	volar
the bomb blew up at night 	la bomba explotó por la noche	explotar
technology blew up the modern modern education system	la tecnología hizo volar el sistema educativo moderno 	hacer volar
the dynamite blew up the building	la dinamita hizo explotar el edificio, la dinamita hizo estallar el edificio, la dinamita destrozó el edificio 	hacer explotar, hacer estallar, destrozar
the terrorist blew up the bomb	la terrorista detonó la bomba	detonar
the exhuasted man finally blew up	el hombre agotado se cabreó finalmente	cabrear se
the teacher blew up	el profesor se calentó	calentar se
the photographer blew up the picture	el fotógrafo agrandó la foto, el fotógrafo amplió la foto	agrandar, ampliar
the parents blew up balloons for the party	los padres inflaron los globos para la fiesta	inflar
the new invention borders on disruptive innovation	la invención nueva limita con la innovación desestabilizadora 	limitar con
various contries border on the Mediterranean sea	varios países lindan con el mar Mediterráneo	lindar con
the man’s ideas borders on stupidity	las ideas del hombre bordean la estupidez	bordear
the man’s behaviour borders on criminal	el comportamiento del hombre roza la delincuencia	rozar
Sincerity at times borders on impertinence 	La sinceridad a veces raya en la impertinencia	rayar en
the ill musician bowed out of the last concert	el músico enfermo se excusó del último concierto	excusar se
the army comptetely bowed out	el ejercito se retiró totalmente	retirar se
the singer bowed out of the competition yesterday	el cantante se retiró de la competición ayer	retirar se de
the island broke away from the landmass	la isla se separó de la masa continental	separar se de
Ireland broke away from the UK in the nineteen-twenties	Irlanda se desvinculó del Reino Unido en los años veinte	desvincular se de
people broke away from commmunism	la gente rompió con el comunismo 	romper con
the machine broke down	la maquina rompió, la maquina se rompió, la máquina se averió, la máquina se estropeó	romper, romper se, averiar se, estropear se
the child broke down	el niño lloró, el niño rompió a llorar	llorar, romper a llorar
the football team broke down at the end	el equipo de fútbol se desmelenó al final	desmelenar se
the digestive enzyme breaks down the protein	la encima digestiva descompone la proteína	descomponer
the car broke down on the motorway	el coche se estropeó en la autopista	estropear se
technology breaks down borders	la tecnología derriba las fronteras	derribar 
lipase breaks down fat molecules	la lipasa descompone las moléculas de grasa  	descomponer
small steps break down complex taks	pequeños pasos desglosan tareas complejas 	desglosar
the scientists break down the experiment’s components	los científicos analizan los pasos del experimento	analizar
the president breaks down the old power structures	el presidente irrumpe en las estructuras de poder antiguas	irrumpir en
the student broke in at the end of the speech	el estudiante interrumpió al final del discurso	interrumpir
the rider broke in the new horse	el jinete domó el caballo nuevo	domar
the girl broke in her new shoes	la chica amoldó sus zapatos nuevos	amoldar
the writer broke in 1990	el escritor murió en 1990	morir en
this debate broke in the last century	este debate irrumpió en el último siglo	irrumpir en
the company will break in a new employee	la empresa formará a un nuevo empleado	formar a
the child broke in the new shoes gradually 	el niño se acostumbró a los zapatos nuevos gradualmente	acostumbrar se a
the thief broke into the house	el ladrón asaltó la casa, el ladrón allanó la casa	asaltar, allanar
the animal broke into a run	el animal se arrancó a correr	arrancar se a
the man broke into the guest’s conversation	el hombre interrumpió la conversación de los huéspedes	interrumpir
the young writer broke into journalism	el joven escritor irrumpió en el periodismo, el joven escritor se metió en el periodismo, el joven escritor se inició en el periodismo	irrumpir en, meter se en, iniciar se en
many countries broke off relations with Israel	muchos países rompieron relaciones con Israel, muchos países terminaron las relaciones con Israel, muchos países suspendieron relaciones con Israel, muchos países pusieron fin a las relaciones con Israel	romper, terminar, suspender, poner fin a
the prisoner broke out of prison	el preso evadió del cárcel, el preso se escapó de la cárcel, el preso se fugó de la cárcel	evadir se de, escapar se de, fugar se
the animals broke out of the zoo	los animales se escaparon del zoo	escapar se de
the Irish rebellion broke out in October	la rebelión irlandesa estalló en octubre	estallar
the country will break out of its recession soon	el país se liberará de su crisis económica pronto	liberar se de
the couple broke up two years later	la pareja rompió dos años después	romper
the surgeon broke up the blot clot	el cirujano se deshizo del coágulo	deshacer se de
nowadays families often break up	las familias se desintegran a menudo hoy en día	desintegrar se
the couple broke up on holidays	la pareja se separó durante las vacaciones	separar se  
the students broke up laughing 	los estudiantes estallaron de risa	estallar de risa
Break up the cake into ten equal slices	Divide la tarta en diez partes iguales	dividir
the war broke the country up	la guerra destruyó el país	destruir
the referee broke up the fight	el árbitro dio fin a la pelea, el árbitro puso fin a la pelea	dar fin a, poner fin a
the girl breathed in deeply	la chica respiró profundamente	respirar
the patient breathed in the bacteria	el paciente inhaló la bacteria	inhalar
the man breathed in through his nose	el hombre aspiró por su nariz	aspirar
the women breathed out her mouth	la mujer exhaló por la boca	exhalar
the new washing powder brightens up the clothes	el detergente nuevo aclara la ropa	aclarar  
the student’s presence brightened up the teacher’s day	la presencia del estudiante mejoró el día del profesor	mejorar
the sky brightened up an hour ago	despejó el cielo hace una hora	despegar
the employees brightened up the office with Christmas decorations	los empleados embellecieron la oficina con adornos navideños 	embellecer
good music brightened up the party	la buena música animó la fiesta	animar 
each emanation brings about a progressive corruption	cada emanación acarrea una progresiva corrupción, cada emanación ocasiona una progresiva corrupción, cada emanación provoca una progresiva corrupción, cada emanación produce una progresiva corrupción, cada emanación proporciona una progresiva corrupción, cada emanación da lugar a una progresiva corrupción	acarrear, ocasionar, provocar, producir, proporcionar, dar lugar a
the girl brought along a friend to the concert	la chica trajo a una amiga al concierto	traer a
the man brought along the dog yesterday	el hombre trajo consigo al perro ayer	traer consigo a
the boy brought back a chocolate bar 	el niño trajo una tableta de chocolate	traer
fashion brings back the same trends every ten years	la moda reintroduce los mismos estilos cada diez años,la moda trae de vuelta los mismos estilos cada diez años, a moda trae de nuevo los mismos estilos cada diez años	reintroducir,  traer de vuelta, traer de nuevo
the food company will bring back the popular sweets	la empresa de alimentos relanzará los caramelos populares	relanzar
that song brings back sad memories	esa canción despierta tristes recuerdos, esa canción evoca recuerdos tristes 	despertar, evocar
friendly fire brought down a plane	fuego amigo derribó un avión, fuego amigo abatió un avión	derribar, abatir 
the clumsy boy brought down the shelf of books	el niño torpe hizo caer la estantería de libros	hacer caer 
the EU brings down corruption	la UE hace desaparecer la corrupción	hacer desaparecer
embarrassing revelations brought down the government	las revelaciones vergonzosas hundieron al gobierno	hundir a
the government brought forward the elections	el gobierno adelantó las elecciones	adelantar
the government brings in new regulations everyday	el gobierno introduce nuevas reglas todos los días	introducir
ambulances bring in sick patients to hospitals	las ambulancias traen a los pacientes enfermos al hospital	traer a
the soldier brought off the dangerous mission	el soldado llevó a cabo la misión peligrosa	llevar a cabo
the woman brought off the surprise party with great success	la mujer llevó a cabo la fiesta sorpresa con éxito	llevar a cabo
the student brought off his goals with aplomb	el estudiante alcanzó sus metas con aplomo, el estudiante logró sus metas con aplomo	alcanzar, lograr
the fatigue of the journey brought on an illness	la fatiga del viaje provocó una enfermedad, la fatiga del viaje causó una enfermedad	provocar, causar
the new policy will bring on controversy	la política nueva suscitará polémica	suscitar
the war will bring on more chaos	la guerra desatará más caos	desatar
the presenter will bring on the first guest now	la presentadora presentará a la primera invitada ahora	presentar a
the teacher brought out the students’ curiousity	El profesor suscitó la curiosidad de los estudiantes 	suscitar
the publisher brought out a new dictionary	el editor sacó un nuevo diccionario, el editor publicó un nuevo diccionario, el editor editó un nuevo diccionario, el editor lanzó un nuevo diccionario	sacar, publicar, editar, lanzar
this light brings out your smile	esta luz resalta tu sonrisa	resaltar
another study brings up a different explanation	otro estudio plantea una explicación diferente	plantear
the single mother brought up three children	la madre soltera crió a tres niños	criar a
parents bring up children with many resources	los padres alimentan a los niños con muchos recursos	alimentar a
the family brought up the adopted child	la familia educó al niño adoptado	educar a
the sick child brought up all the lunch	el niño enfermo devolvió toda la comida	devolver
the sick child brought up all the lunch	el niño enfermo vomitó toda la comida	vomitar
the deputy brushed off the congressional demand	el diputado ignoró la demanda del congreso, el diputado ninguneó la demanda del congreso, el diputado menospreció la demanda del congreso 	ignorar, ningunear, menospreciar
the diplomat brushed up on his French	el diplomático refrescó su francés el año pasado	refrescar
the pilot brushed up on his training	el piloto repasó su formación	repasar
the cat brushed up agained the boy’s leg	el gato rozó la pierna del niño	rozar
the student brushed up on history	el estudiante repasó historia	repasar
the man buckled up in the car	el hombre se abrochó el cinturón en el coche	abrochar se el cinturón
the boy buggered off 	el chico se largó	largar se
the annoying man buggered off	el hombre molesto ahuecó el ala	ahuecar el ala
the developer built on reclaimed land	el constructor construyó sobre tierra reclamada	construir sobre
the man didn’t build on the flood plain	el hombre no construyó en la llanura aluvial	construir en
the music of my country is built on folk tradition	la música de mi país se basa en la tradición popular	basar se en
they built up the wall using bricks made from local stone 	levantaron las paredes con ladrillos de adobe	levantar
the workers built up the outer walls	los obreros erigieron las fachadas	erigir
the researcher built up an interesting theory	el investigador desarrolló una interesante teoría	desarrollar
young people build up opportunities to earn money	la gente joven construye las oportunidades para ganar dinero	construir 
the patient built up his arm strength	el paciente reforzó la fuerza del brazo	reforzar
the music of my country is built upon folk tradition	la música de mi país se basa en la tradición popular	basar se en
the researcher built upon his predecessor’s work	el investigador desarrolló el trabajo de su predecesor	desarrollar
the new rules are built upon existing legislation	las nuevas normas se basan en la legislación vigente	basar se en
the culture is built upon a varied history	construyó la cultura sobre una historia amplia	construir sobre
the researcher bumped into new problems	el investigador se topó con problemas nuevas	topar se con 
the bus bumped into a tree	el autobús chocó contra un árbol, el autobús chocó con un árbol	chocar contra, chocar con
the woman bumped into her friend in the street	la mujer se encontró con su amigo en la calle	encontrar se con
my son bumped into a branch	mi hijo tropezó con una rama	tropezar con
the teacher bumped into the student before class	el profesor se topó con el alumno antes de la clase	topar se con 
the bad boys burned down the hotel	los chicos malos incendiaron el hotel	incendiar
the hotel burned down	el hotel ardió, el hotel se quemó	arder, quemar se
the fire burned down the old cinema	el incendio consumió el cine antiguo	consumir
the fire burned down the old empty warehouses	el incendio derrumbó los almacenes viejos vacíos	derrumbar
the fire burned away all the evidence	el incendio consumió todas las pruebas	consumir
the important letters burned away in the fireplace	Ardieron las cartas importantes en la chimenea	arder
the fire burned away the evidence of the crime	el incendio quemó las pruebas del crimen	quemar
the evidence was all burned away	se incendiaron todas las pruebas 	incendiar se
the fire burned out	el fuego se consumió, el fuego se apagó	consumir se, apagar se
the forest fire burnt out after two days	el incendio forestal se agotó después de dos días	agotar se
the sick boy burned up all weekend	el niño enfermo ardió de fiebre todo el fin de semana	arder de fiebre
the angry man burned up 	el hombre enfadado se puso furioso	poner se furioso
the rude woman butted into the couple’s conversation	la mujer maleducada se entrometió en la conversación de la pareja	entrometer se en
the rude woman butted into the couple’s conversation	la mujer maleducada se metió en la conversación de la pareja	meter se en
Management buttered up the meeting by talking about bonuses before talking about redundancies	La dirección suavizó la reunión hablando de las bonificaciónes antes de hablar de los despedidos	suavizar
the students buttered up the teacher all morning	los estudiantes doraron la píldora a la profesora todo la mañana	dorar la píldora a
many investors buy up large quantities of land	muchos inversores acaparan grandes cantidades de terreno, muchos inversores acopian grandes cantidades de terreno	acaparar, acopiar
the driver called around on the way home	el conductor llamó por ahí de camino a casa	llamar por ahí
the ship will call at the island	el barco hará escala en la isla, el barco parará en la isla	hacer escala en, para en
the commercial vessel called at the port	el buque comercial paró en el puerto, el buque comercial hizo escala en el puerto	parar en, hacer escala en
the boss called back the employee	el jefe devolvió la llamada al empleado	devolver la llamada a
the father called down the girl for bad behaviour	el padre regañó a la niña por comportarse mal	regañar a
all nations call for the prisoner’s release	todas las naciones exigen la liberación del preso	exigir
the manufacturing system calls for flexible workers	el sistema de fabricación requiere trabajadores flexibles	requerir
the forecast calls for clear skies 	la previsión meteorológica pronostica cielos despejados	pronosticar
It's time to call the children in for supper	Es hora de hacer pasar a los niños a cenar	hacer pasar a
the student union calls off the demonstration	el sindicato de estudiantes cancela la manifestación, el sindicato de estudiantes suspende la manifestación	cancelar, suspender
the president calls on the Arab population	el presidente apela a la población árabe	apelar a
the government called on nutritional experts	el gobierno recurrió a expertos en nutrición	recurrir a
the woman called on the family	la mujer visitó a la familia	visitar a
the doctor called on the man	el médico visitó al hombre	visitar a
the man called out loudly	el hombre gritó a todo volumen	gritar
the man called out to the victim	el hombre gritó a la víctima	gritar a
the general called out the soldiers	el general convocó a los soldados	convocar a
the students called out the teacher	los estudiantes desafiaron al profesor	desafiar a
the politician called out the commission	el político retó a la comisión 	retar a
the girl called over the other children	la niña invitó a los otros niños	invitar a
the man called up the organisation	el hombre telefoneó a la organización 	telefonear a
the woman called up the bank	la mujer llamó al banco	llamar a
the company will call up more workers	la empresa reclutará a más trabajadores	reclutar a
the government called upon the voters	el gobierno recurrió a los votantes	recurrir a
the boy calmed down	el niño se calmó	calmar se
the music calmed down the baby	la música calmó el bebé	calmar  
the teacher calmed down the two brothers	el profesor apaciguó a los dos hermanos	apaciguar a
the music calmed down the patient’s nerves	la música sosegó los nervios del paciente	sosegar
the priest cares for their spiritual needs	el cura cuida de sus necesidades espirituales, el cura se ocupa de sus necesidades espirituales	cuidar de, ocupar se de
the man carried along the musical instrument	el hombre trajo el instrumento musical	traer
the woman carried along the boy	la mujer llevó al niño	llevar  a
the thief carried off the diamonds	el ladrón se llevó los diamantes	llevar se 
a man carried off the child	un hombre secuestró al niño	secuestrar a
the young man carried off the jewels	el hombre joven robó las joyas	robar
the man carried off the red hat in style	el hombre se llevó el sombrero rojo	llevar se 
the gymnast carried off the gold medal	el gimnasta logró la medalla de oro	lograr
the programme carries on	el programa prosigue, el programa continúa	proseguir, continuar
classical philosophers carry on this tradition	filósofos clásicos prosiguen esta tradición, filósofos clásicos continúan esta tradición	proseguir, continuar
the students continued on with the homework	los estudiantes continuaron con los deberes	continuar con
a computer programme carried out the same task	un programa de ordenador realizó la misma tarea, un programa de ordenador hizo la misma tarea, un programa de ordenador completó la misma tarea, un programa de ordenador llevó a cabo la misma tarea 	realizar, hacer, completar, llevar a cabo
the employee carried out all the necessary tasks	el empleado cumplió con las tareas necesarias	cumplir con
the man didn´t catch on it	el hombre no lo captó, el hombre no lo pilló, el hombre no lo entendió, el hombre no lo comprendió	captar, pillar, entender, comprender
the woman didn´t catch on	la mujer no entendió, la mujer no comprendió	entender, comprender
the man caught onto the dog	el hombre agarró al perro	agarrar a
the student didn’t catch onto the idea	el estudiante no pescó la idea	pescar
the runner caught up with the other competitors	el corredor alcanzó a los otros competidores                                                                                                                                                                                                                                                                                                                                                   	alcanzar a 
the boss caught up with her emails	la jefa se puso al día con los correos electrónicos	poner se al día con
the company caught up with that modern efficiency	la empresa alcanzó esa eficiencia moderna	alcanzar 
the lack of land caught up with the settlers	la falta de tierra alcanzó a los colonos, la falta de tierra pasó factura a los colonos	alcanzar a, pasar factura a
the police caught up with the criminal	la policía pilló al criminal	pillar a
the police caught up with a Spanish gang	la policía atrapó a una banda española, la policía capturó a una banda española	atrapar a, prender a, capturar a
the woman caught up with her friend	la mujer se reencontró con su amiga	reencontrar se con
this small bar caters to students	este pequeño bar atiende a estudiantes	atender a
distance learning caters to workers	el aprendizaje a distancia beneficia a los trabajadores	beneficiar a
the company catered to the market demand	la empresa abasteció a la demanda del mercado	abastecer a
the hotel catered to the guests’ every demand	el hotel complació a las demandas exigentes de los clientes	complacer a
the tragedy changed into a pathetic melodrama	la tragedia se transformó en un melodrama patético, la tragedia se convirtió en un melodrama patético	transformar se en, convertir se en
the man changed into a suit	el hombre se puso un traje	poner se  
Spain changed over to the euro in 1999	España cambió al euro en 1999	cambiar a
hotels charge for accommodation	los hoteles piden dinero por alojamiento, los hoteles cobran por alojamiento 	pedir dinero por, cobrar por
the journalist chased up the story	la periodista hizo un seguimiento de la historia	hacer un seguimiento
my brother chatted up a bookshop owner	mi hermano cameló a un propietario de una librería	camelar a
those people cheated on the video game	esas personas hicieron trampa en el videojuego	hacer trampa en 
the boy cheated on his brother in the game	el chico hizo trampa a su hermano en el juego, el chico engañó a su hermano en el juego	hacer trampa a, engañar a
the government cheated on its voters	el gobierno engaña a sus electores	engañar a
the hotel guest checked in late last night	el huésped de hotel se registró tarde anoche	registrar se
the police checked into the suspect’s alibi	la policía verificó la coartada del sospechoso	verificar
the security men are checking on each entrance	los hombres de seguridad comprueban cada acceso	comprobar
the passenger will check in the luggage	el pasajero facturará el equipaje	facturar
the employee checked in with the boss yesterday	el empleado se puso en contacto con el jefe ayer, el empleado contactó con el jefe ayer	poner se en contacto con, contactar con 
the guest checked into the hotel two days ago	el huésped se registró en el hotel hace dos días	registrar se
the parents checked on the sick child every hour	los padres controlaron al niño enfermo cada hora	controlar a
the inspector checked on each entrance	el inspector chequeó cada acceso, el inspector comprobó cada acceso, el inspector verificó cada acceso	chequear, comprobar, verificar
the police checked out the suspect’s story	la policía verificó la historia del sospechoso	verificar
the girl checked out a book	la niña sacó un libro	sacar
the agent checked out the plane	el agente verificó el avión, el agente comprobó el avión, el agente revisó el avión	verificar, comprobar, revisar
the detective checked out the scene of the crime	el detective investigó el lugar del crimen	investigar
the buyer checked out the quality of the product	el comprador se fijó en la calidad del producto	fijar se en
the guest checked out at midday	el huésped salió del hotel a mediodía 	salir de
the rockstar checked out after an overdose	la estrella de rock se murió después de una sobredosis, la estrella de rock se fue al otro barrio después de una sobredosis	morir se, ir se al otro barrio
the lawyers checked through the issue in half an hour	los abogados despacharon el asunto en media hora 	despachar
the airport checked through my bags for all three flights	el aeropuerto facturó mis maletas para los tres vuelos	facturar
the spectators are cheering on the competitor	los espectadores alientan al competidor, los espectadores animan al competidor	alentar a, animar a
the fans cheer on their team	los fans vitorean a su equipo	vitorear a
chocolate always cheers the child up	el chocolate alegra al niño siempre	alegrar a
the man’s jokes cheered me up	los bromas del hombre me animaron	animar a
the son's visit cheered the man up	la visita del hijo alegró al hombre	alegrar 
at the debate the woman chipped in	en el debate la mujer intervino	intervenir
the man chipped in to the conversation	el hombre interrumpió la conversación	interrumpir
the friends chipped in to the holiday fund	los amigos pusieron dinero para el bote de las vacaciones, los amigos contibuyeron dinero para el bote de las vacaciones	poner dinero para, contribuir a
the children will chip in five dollars	los niños pondrán cinco dólares, los niños aportarán cinco dólares, los niños contribuirán con cinco dólares, 	poner, aportar, contribuir con
the woodcutter chopped down the tree	el leñador cortó el árbol, el lenador taló el árbol	cortar, talar
the chef chopped up the vegetables	el cocinero picó las verduras, el cocinero troceó las verduras	picar, trocear
the workers cleaned out a storage room	los trabajadores limpiaron una sala de almacenamiento, los trabajadores ordenaron una sala de almacenamiento	limpiar, ordenar
the programmer cleaned out the bug	el programador dio cuenta del bug	dar cuenta de
his ex-girlfriend cleaned the man out	su exnovia dejó sin nada al hombre	dejar sin nada a
the man cleaned out the garage	el hombre limpió el garaje	limpiar
the girl cleaned out the wardrobe	la chica vació el armario 	vaciar
the politician cleaned up his image	el político limpió su imagen	limpiar
the government is going to clean up the system	el gobierno va a reformar el sistema	reformar
the woman cleared away the books	la mujer organizó los libros	organizar
the boys cleared off at five o´clock	los chicos se marcharon a las cinco, los chicos se fueron a las cinco	marchar se, ir se
the housekeeper cleared out the cupboard	el ama de llaves vació el armario	vaciar
the teacher cleared up the mess	el profesor limpió el desorden	limpiar
the teacher’s answer cleared up the problem	la respuesta del profesor explicó el problema	explicar
that message cleared up doubts	ese mensaje aclaró las dudas, ese mensaje resolvió las dudas, ese mensaje despejó las dudas	aclarar, resolver, despejar
the employee climbed up the corporate ladder quickly	el empleado ascendió el escalafón profesional rápido	ascender
the lion climbed up a tall tree	el león escaló un árbol alto, el león se subió a un árbol alto, el león trepó a un árbol alto	escalar, subir se a, trepar a
the prosecutor closed down the newspaper	el fiscal cerró el periódico	cerrar
the manager closed down that part of the company	el director clausuró esa parte de la empresa	clausurar
the man’s  death came about in 1981	la muerte del hombre sucedió en 1981, la muerte del hombre ocurrió en 1981, la muerte del hombre aconteció en 1981	suceder, ocurrir, acontecer
the yacht came about	el yate viró	virar
the researcher came across an interesting study	el investigador se topó con un interesante estudio, el investigador se encontró con un interesante estudio	topar se con, encontrar se con
the woman came across the man in the street	la mujer se cruzó con el hombre en la calle	cruzar se con
the man came across as rude	el hombre dio la impresión de ser maleducado, el hombre pareció maleducado	dar la impresión de ser, parecer
the woman came across as nice  (delete)	la mujer pareció simpática	parecer
the man came across with the information	el hombre soltó la información	soltar
the police came after the thieves 	la policía persiguió a los ladrones, la policía iba detrás de los ladrones	perseguir a, ir detrás de
the Spanish contribution came after the war of 1812	la contribución española siguió a la guerra de 1812, la contribución española llegó después de la guerra de 1812, la contribución española se produjo después de la guerra de 1812, la contribución española vino después de la guerra de 1812	seguir a, llegar después de, producir se después de, venir después de
our projects are coming along very well	nuestros proyectos están progresando muy bien, nuestros proyectos están avanzando muy bien	progresar, avanzar
his brother came along	llegó su hermano, vino su hermano	llegar , venir
the boss came along 	el jefe apareció	aparecer
the man came along to the party	el hombre se presentó en la fiesta, el hombre vino a la fiesta, el hombre llegó a la fiesta	presentar se, venir, llegar
the man came along with the family	el hombre acompañó a la familia	acompañar a
the teacher came along to the party  borrar	el profesor vino a la fiesta	venir
the jumper came apart at the seams	el jersey se deshizo por las costuras	deshacer se
the machine came apart	la máquina se desarmó	desarmar se
the engine came apart from the machine	se desprendió el motor de la maquina	desprender se
spring came around late this year	la primavera volvió tarde este año, la primavera llegó tarde este año	volver, llegar
my father came around to my opinion	mi padre se dejó convencer por mi opinión	dejar se convencer
the boy came around to the majority’s opinion soon	el chico se puso de acuerdo con la opinión de la mayoría pronto	poner se de acuerdo
I came around to your house	me dejé caer por tu casa, vine a tu casa	dejar se caer por, venir
the girl came around to my house	la chica vino a mi casa borrar	venir
the teacher came back yesterday	la profesora volvió ayer, la profesora regresó ayer	volver, regresar
the team came back last week, delete	el equipo regresó la semana pasada	regresar
the patient came down three kilos last week	el paciente bajó tres kilos la semana pasada	bajar  
the old man came down the stairs	el anciano descendió las escaleras, el anciano bajó las esclaeras	descender, bajar 
the building came down in the floods 	el edificio se vino abajo en las inundaciones	venir se abajo
the wall came down in the earthquake	la muralla se desmoronó con el terremoto	desmoronar se
the abandoned house came down	la casa abandonada se derrumbó	derrumbar se
the tree came down on the car	el árbol cayó encima del coche	caer encima de
the argument came down to logic	la discusión dependió de la lógica	depender de
their son came down with polio	su hijo cogió la polio, su hijo contrajo la polio, su hijo se enfermó de polio	coger, contraer, enfermar se de
the candidate came forward for the campaign	el candidato se presentó para la campaña	presentar se
the boy came forward as a volunteer	el chico se ofreció voluntario	ofrecer se
the witness came forward to the police	el testigo se puso a disposición de la policía	poner se a disposición de
the man’s fortune comes from illegal activities	la fortuna del hombre procede de actividades ilícitas, la fortuna del hombre proviene de actividades ilícitas	proceder de, provenir de
the aroma comes from the kitchen	el aroma proviene de la cocina 	provenir de
the teacher comes from England	el profesor viene de Inglaterra 	venir de
the boss came in yesterday	el jefe entró ayer	entrar  
the athlete came in second in the marathon	la atleta llegó segunda en el maratón	llegar  
the man comes into the second part of the plan	el hombre se mete en la segunda parte del plan	meter se
the woman came into a large inheritance 	la mujer accedió a una gran herencia	acceder a
the man came into the restaurant	el hombre entró en el restaurante	entrar en
leather sandals came into fashion this summer	las sandalias de piel se pusieron de moda este verano	poner se de  
the Internet came into being in the eighties	la red nació en los años ochenta	nacer
the invention came of his original idea	la invención resultó de su idea original, la invención surgió de su idea original	resultar de, surgir de
the man came of age during the Second World War	el hombre llegó a mayoría de edad durante la segunda guerra mundial	llegar a la mayoría de edad
the party came off without problems	la fiesta sucedió sin incidencias, la fiesta tuvo lugar sin incidencias	suceder, tener lugar
the addict came off heroin two months ago	el drogadicto se quitó de la heroína hace dos meses	quitar se de
the sticker came off the book	la pegatina se separó del libro	separar se de
the woman came onto the handsome man	la mujer coqueteó con el hombre guapo, la mujer ligó con el hombre guapo	coquetear con, ligar con
the speaker will come on to that topic in a moment	el orador pasará a este tema enseguida	pasar a
the student came out last night	el estudiante salió anoche	salir de
the woman came out quickly	la mujer apareció rápido, la mujer salió rápido	aparecer, salir
the man came out yesterday	el hombre se declaró ayer	declarar se
a cook book will come out soon	un libro de cocina se publicará pronto	publicar se
women came out at the debutante ball in the past	las mujeres se presentaron en el baile de debutantes	presentar se
the band’s new CD came out yesterday	el CD nuevo del grupo se estrenó ayer	estrenar se
the information came out in court	la información se divulgó en el tribunal	divulgar se
the news came out suddenly	las noticias se filtraron de repente	filtrar se
the athlete came out of his retirement	el atleta salió de su retiro	salir de
the cost of the breakages came out of the deposit	el costo de los daños se descontó de la fianza	descontar se
this noise comes out of the filter	este ruido sale del filtro, este ruido proviene del filtro	salir de, provenir de
the results came out of the study	los resultados surgieron del estudio	surgir de
the woman came over yesterday	la mujer se vino ayer, la mujer vino ayer	venir se , venir
the students came over at lunchtime	los estudiantes se pasaron a la hora de comer, los estudiantes vinieron a la hora de comer	pasar se, venir
the English came over two hundred years ago	los ingleses invadieron hace doscientos años	invadir
fear came through his whole body	el miedo se notó en su cuerpo entero, el miedo se manifestó en su cuerpo entero	notar se, manifestar se
the girl will come through this terrible experience	la chica superará esta experiencia terrible 	superar
the man came through a traumatic childhood	el hombre superó una niñez traumática 	superar
the man came to yesterday	el hombre volvió en sí ayer	volver en sí
the news came to the boy in a letter	las noticias llegaron al chico en una carta	llegar a    
the results came to the students 	las notas llegaron a los estudiantes	llegar a    
the controversial questions came up in the debate	las preguntas polémicas salieron en el debate, las preguntas polémicas surgieron en el debate	salir, surgir 
a new issue will come up , delete	un nuevo problema surgirá,aparecerá, saldrá	surgir
the sun came up early today	el sol se levantó temprano hoy, el sol salió temprano hoy	levantar se, salir
something came up suddenly	algo pasó de repente, algo ocurrió de repente, algo sucedió de repente	pasar, ocurrir, suceder  
the employee came up the boss’s office	el empleado subió al despacho del jefe	subir a
the moon came up over the sea	la luna se elevó sobre el mar	elevar se
the man came up to the student in school	el hombre se acercó al estudiante en el colegio	acercar se a
the company came up with a bold plan	la empresa elaboró un plan audaz	elaborar
the politician came up against strong opposition	el político se topó con una fuerte oposición, el político se tropezó con una fuerte oposición	topar se con, tropezar se con
the boxer came up against his opponent	el boxeador compitió contra su rival, el boxeador compitió con su rival 	competir contra, competir con
the president came up with a new strategy	el presidente se inventó una estrategia nueva	inventar se
the teacher came up with enough money to pay for the books	el profesor consiguió dinero suficiente para pagar los libros	conseguir
the company covered up deficiency	la empresa tapó la deficiencia, la empresa escondió la deficiencia	tapar, esconder
the student covered up his notes before the exam	el estudiante cubrió sus apuntes antes del examen	cubrir
the criminal covered up the evidence	el criminal escondió las pruebas	esconder
the corruption scandal was covered up	el escándalo de la corrupción se tapó	tapar se
the books were covered up with new covers	se cubrieron los libros con sobrecubiertas nuevas	cubrir se
students count on their teachers everyday	los estudiantes cuentan con sus profesores todos los días 	contar con
many people count on modern medicine 	mucha gente confía en la medicina moderna, mucha gente se fia de la medicina moderna	confiar en, fiar se de
the police cracked down on drink driving	la policía tomó medidas contra la conducción bajo los efectos del alcohol	tomar medidas contra
the government cracked down on the insurgents	el gobierno acabó con los insurgentes, el gobierno castigó a los insurgentes	acabar con, castigar a
the man crossed the name off the list	el hombre tachó el nombre de la lista	tachar a
the interviewer crossed the unsuitable candidate off	el entrevistador eliminó al candidato inadecuado	eliminar a
the boy crossed out the number	el muchacho tachó el número	tachar a
the child cried out	el niño gritó, el niño chilló	gritar, chillar
the mother cried out for help	la madre pidió a gritos ayuda	pedir a gritos
the girl curled up on the couch	la niña se acurrucó en el sofá 	acurrucar se
the dog curled up in front of the door	el perro se enroscó delante de la puerta	enroscar se
the corners of the map curled up	las esquinas del mapa se enrollaron	enrollar se
the government cut back unemployment benefit	el gobierno recortó las prestaciones por desempleo, el gobierno redujo las prestaciones por desempleo	recortar, reducir
the president cut back immigration	el presidente restringió la inmigración	restringir
the family cut back on expenses	la familia recortó en los gastos	recortar en
the algorithm cut down the cost of computation	el algoritmo bajó el costo de computación, el algoritmo redujo el costo de computación	bajar, reducir
the woodcutter cut down the tree	el leñador cortó el árbol, el leñador taló el árbol	cortar, talar
enemy fire cut down the soldiers	el fuego enemigo derribó a los soldados, el fuego enemigo liquidó a los soldados, el fuego enemigo mató a los soldados	derribar a, liquidar a, matar a
the business cut down on operating expenses	la empresa redujo los gastos de operación, la empresa recortó en gastos de operación	reducir, recortar en
the driver cut in quickly	el conductor se adelantó rápido	adelantar se
the rude man cut in the queue	el hombre maleducado se coló	colar se
the woman cut in our conversation	la mujer se entrometió en nuestra conversación	entrometer se en
the man was cut in on the prize money	el dinero del premio se compartió con el hombre	compartir se con
the man cut off her hand	el hombre se amputó la mano, el hombre se cortó la mano	amputar se, cortar se
the father cut off his son	el padre repudió a su hijo, el padre se apartó de su hijo, el padre se distanció de su hijo	repudiar a, apartar se de, distanciar se de
the phone call was cut off	la llamada se cayó, la llamada se desconectó 	caer se, desconectar se
the woman cut the speaker off	la mujer interrumpió al orador	interrumpir a
the government cut out scholarships	el gobierno recortó las becas	recortar  
the director cut out the most violent scene	el director sacó la escena más violenta	sacar
the woman cut carbohydrates out of her diet	la mujer eliminó hidratos de carbono de su dieta, la mujer suprimió hidratos de carbono de su dieta	eliminar, suprimir
the children cut pictures out of magazines	los niños cortan las imágenes de las revistas	cortar
the man cut the stress out of his work	el hombre eliminó el estrés de su trabajo, el hombre quitó el estrés de su trabajo	eliminar, quitar
the television cut out last night	la televisión se cortó anoche	cortar se
the student cut out after the exam	el estudiante se piró después del examen	pirar se
the police cut up his passport	la policía troceó su pasaporte	trocear
the chef cut up an onion	el cocinero picó una cebolla	picar
the man is cut up after his brother’s death	el hombre está fatal después de la muerte de su hermano	estar fatal
the table dates back to the eighteenth century 	la mesa data del siglo dieciocho, la mesa es del siglo dieciocho	datar de, ser de
the church dates from 1596	la iglesia data de 1596	datar de  
the facts of the story dawned on the man	los hechos de la historia ocurrieron al hombre	ocurrir a
the firm deals in industrial lubricant	la compañía trata con lubricante industrial	tratar сon
the man dealt his friend into the poker game	el hombre incluyó a su amigo en el juego de poker, el hombre mitió a su amigo en el juego de poker	incluir a, meter en
the business deals in new technology	la empresa integra a la nueva tecnología	integrar a
the boss deals with the most demanding customers	el jefe lidia con los clientes más exigentes, el jefe se ocupa con los clientes más exigentes	lidiar con, ocupar se de 
the worker dealt with the customer’s problem	el empleado resolvió el problema del cliente	resolver  
the book deals with geography	el libro trata trata de geografía	tratar  de
several financial institutions deal with private funds	varias instituciones financieras tratan con fondos privados, varias instituciones financieras negocian con fondos privados, varias instituciones financieras se ocupan de fondos privados, varias instituciones financieras se encargan de fondos privados, varias instituciones financieras manejan fondos privados, varias instituciones financieras gestionan fondos privados	tratan con, negociar con, ocupar se de, encargar se de, manejar, gestionar
nurses deal with the drunk patients	las enfermeras se ocupan de los pacientes borrachos, las enfermeras soportan a los pacientes borrachos	ocupar se de, soportar a
the child dealt with traumatic experiences	el niño hizo frente a experiencias traumáticas, el niño se enfrentó con experiencias traumáticas	hacer frente a, enfrentar se con 
the producer decided on this location	el productor escogió esta localización, el productor eligió esta localización, el productor optó por esta localización	escoger, elegir, optar por
the man delighted in the singer’s voice	el hombre se deleitó con la voz del cantante	deleitar se con
the police officer delved into the case	el policía indagó en el caso	indagar en
the patient depends on the medication	el paciente confía en sus medicamentos	confiar en  
universities depend on investment	las universidades cuentan con la inversión	contar con
people depend on financial institutions	la gente depende de las instituciones financieras 	depender de
the bees died away in winter	las abejas murieron en el invierno	morir
the noise died down after the concert	el ruido disminuyó después del concierto	disminuir  
the scandal eventually died down	el escándalo se apagó eventualmente	apagar se  
their old ideas will die off soon	sus viejas ideas se extinguirán pronto, sus viejas ideas desaparecerán pronto, sus viejas ideas se desvanecerán pronto, sus viejas ideas se perderán pronto	extinguir se, desaparecer, desvanecer se, perder se
the hungry boy dug in	el chico hambriento atacó, el chico hambriento empezó a comer	atacar, empezar a comer
the soldiers dug in	los soldados se instalaron, los soldados se establecieron, los soldados se atrincheraron	instalar se, establecer se, atrincherar se
the soldiers dug into the hill	los soldados se instalaron en la colina, los soldados se establecieron en la colina, los soldados se atrincheraron en la colina	instalar se en, establecer se en, atrincherar se en
the stubborn man dug in 	el hombre terco no cedió	no ceder
the girl dug up a corpse	la chica desenterró un cadáver, la chica exhumó un cadáver	desenterrar, exhumar
the newspaper dug up all the information about the scandal	el periódico reveló todo sobre el escándalo, el periódico expuso todo sobre el escándalo, el periódico descubrió todo sobre el escándalo, 	revelar, exponer, descubrir
the woman dipped into a magazine	la mujer hojeó una revista	hojear
the man dipped into his savings	el hombre recurrió a sus ahorros	recurrir a  
the association dished out food	la asociación repartió alimentos, la asociación sirvió alimentos	repartir, servir
the army disposed of toxic substances	el ejército se deshizo de sustancias tóxicas, el ejército tiró sustancias tóxicas, el ejército deshechó sustancias tóxicas	deshacer se de, tirar, deshechar
the athlete disposed of the competition	el atleta acabó con los competidores, el atleta terminó con los competidores	acabar con, terminar con
the man divided up the food	el hombre dividió la comida, el hombre separó la comida	dividir, separar
my mother divided up the money	mi madre repartió el dinero	repartir
the worker did over the spreadsheet	el trabajador rehízo la hoja de cálculo	rehacer
the government did away with compulsory military service	el gobierno eliminó el servicio militar obligatorio	eliminar
socialism did away with private property	el socialismo acabó con la propiedad privada, el socialismo se deshizo de la propiedad privada, el socialismo se cargó la propiedad privada	acabar con, deshacer se de, cargar se
the man did in his neighbour	el hombre se cargó a su vecino	cargar se a
the marathon did the man in 	el maratón cansó al hombre, el maratón agotó al hombre	cansar a, agotar a 
the race did in the man’s knee	la carrera lastimó la rodilla del hombre	lastimar
my son did up the room	mi hijo redecoró la habitación, mi hijo remodeló la habitación, mi hijo renovó la habitación, mi hijo reacondicionó la habitación	redecorar, remodelar, renovar, reacondicionar
the woman did up her coat	la mujer abrochó su abrigo, la mujer abotonó su abrigo	abrochar, abotonar 
the constitution did without reference to religion	la constitución obvió referencias a la religión	obviar
the man did without a new car	el hombre prescindió de un coche nuevo	prescindir de
the school did without the latest technology	el colegio vivió sin la última tecnología 	vivir sin
the student nodded off during the boring class	el estudiante cabeceó durante la clase aburrida, el estudiante se quedó dormido durante la clase aburrida	cabecear, quedar se dormido
the class dragged on 	la clase siguió machaconamente	seguir machaconamente
the teacher drew on his knowledge	el profesor recurrió a sus conocimientos, el profesor usó sus conocimientos, el profesor utilizó sus conocimientos	recurrir a, usar, utilizar
the film drew on his childhood	la película se basó en su infancia, la película se inspiró en su infancia	basar se en, inspirar se en
the man quickly drew on his trousers	el hombre se puso sus pantalones rápido	poner se  
the man quickly drew on his clothes	el hombre se vistió rápido	vestir se
the players drew out the football match	los jugadores prolongaron el partido de fútbol	prolongar
the student drew out his studies for years	el estudiante siguió sus estudios durante años, el estudiante continuó sus estudios durante años	seguir, continuar
detectives draw out criminals’ secrets	los detectives sonsacan los secretos de los criminales	sonsacar
the researcher drew up an article	el investigador redactó un artículo	redactar
the manager drew up a new project	el gerente elaboró un nuevo proyecto	elaborar
the teacher drew up a seat 	el profesor trajó una silla, el profesor acercó una silla, el profesor se acercó una silla, el profesor aproximó una silla	traer, acercar, acercar se, aproximar se
the man drew up a seat to the table	el hombre acercó una silla a la mesa, el hombre aproximó una silla a la mesa	acercar, aproximar
the woman drew up water from the well	la mujer sacó agua del pozo	sacar  
the car drew up  	el coche llegó  	llegar  
the car drew up to the house, delete	el coche llegó a la casa	llegar  
the student drew upon his own experience	el estudiante recurrió a su experiencia propia	recurrir a  
the child dreams of a lot	el niño sueña mucho, el niño fantasea mucho, el niño imagina mucho	soñar, fantasear,  imaginar
the man dreamt of his family	el hombre soñó con su familia, el hombre fantaseó con su familia	soñar con, fantasear con
the engineer dreams up wonderful inventions	el ingeniero imagina invenciones fantásticas, el ingeniero inventa invenciones fantásticas	imaginar, inventar
the boy dreamed up the story	el muchacho fabuló la historia, el muchacho se imaginó la historia, el muchacho se inventó la historia	fabular, imaginar se, inventar se
the woman dressed up for the party	la mujer se emperifolló para la fiesta, la mujer se puso elegante para la fiesta	emperifollar se, poner se elegante
the child dressed up	el niño se disfrazó 	disfrazar se
the parents dressed up their child	los padres disfrazaron a su hijo	disfrazar a
the father dressed his daughter up	el padre vistió elegante a su hija, el padre puso elegante a su hija	vestir elegante, poner elegante
the man drove away	el hombre se alejó conduciendo	alejar se conduciendo
this spray drives away insects	este espray aleja los insectos, este espray repele los insectos, este espray ahuyenta los insectos, este espray espanta los insectos	alejar, repeler, ahuyentar, espantar 
the thief drove off	el ladrón se alejó en coche, el ladrón se fue, el ladrón se marchó	alejar se en coche, ir se, marchar se
the police drove of the protesters	la policía ahuyentó a los manifestantes, la policía espantó a los manifestantes	ahuyentar a, espantar a
the wind drove off the storms	el viento echó las tormentas, el viento expulsó las tormentas	echar, expulsar
the student dropped back a year	el estudiante se quedó un curso atrás	quedar se atrás
my neighbour dropped by yesterday	mi vecino pasó ayer, mi vecino se pasó ayer, mi vecino se dejó caer ayer	pasar, pasar se, dejar se caer
the customer dropped in 	el cliente se dejó caer, el cliente pasó	dejar se caer, pasar
the woman dropped in on her neighbour yesterday	la mujer visitó a su vecino ayer	visitar a
the woman dropped in on the new hotel	la mujer visitó el nuevo hotel	visitar  
income dropped off substantially	los ingresos decrecieron considerablemente, los ingresos cayeron considerablemente	decretar, caer
the tired man dropped off 	el hombre cansado dio una cabezada	dar una cabezada
the priest drove away the demon	el cura alejó al demonio, el cura repelió al demonio, el cura ahuyentó al demonio, el cura espantó al demonio	alejar a, repeler a, ahuyentar a, espantar a
their aid drove out the invaders	su ayuda expulsó a los invasores, su ayuda echó a los invasores	expulsar a, echar a
the river drops off a plateau	el río lleva a una meseta	llevar a
the student dropped out of university	el estudiante dejó la universidad, el estudiante abandonó la universidad	dejar, abandonar
my neighbour dropped over yesterday	mi vecino se pasó ayer, mi vecino se dejó caer ayer	pasar se, dejar se caer
his management is drumming up sales	su gestión está fomentando las ventas, su gestión está aumentando las ventas	fomentar, aumentar
the politician is drumming up controversy	el político está suscitando una polémica, el político está causando una polémica	suscitar, causar
the lake dried up	el lago se secó	secar se
the water supply dried up	el suministro de agua se agotó, el suministro de agua se consumió	agotar se, consumir se
the surprised student dried up	el estudiante sorprendido se calló	callar se
the teacher dumbed down the subject	el profesor simplificó la asignatura	simplificar
the man dwelled on his failed relationship	el hombre pensó obsesivamente en su relación fracasada	pensar obsesivamente en
the girl was dying for lunch	la chica se moría por comer	morir se por
the teacher eased off his students a little	el profesor aflojó un poco con sus estudiantes, el profesor se moderó un poco con sus estudiantes, el profesor alivió un poco a sus estudiantes, 	aflojar con, moderar se con, aliviar a
the boss eased on on his employees	el jefe trató mejor a sus empleados	tratar mejor a
regional unemployment fell away last year	la tuberculosis está carcomiendo sus huesos, la tuberculosis está minando sus huesos, la tuberculosis está royendo sus huesos, la tuberculosis está corroyendo sus huesos, la tuberculosis está desgastando sus huesos	carcomer, minar, roer, corroer, desgastar
water ate away the stone in the caves	el agua erosionó la piedra de las cuevas	erosionar
the family ate in last night	la familia cenó en casa anoche	cenar en casa
heat ate up your fat reserve	el calor consumió tu reserva de grasa	consumir
the unemployed man ate into his savings	el hombre desempleado se comió sus ahorros	comer se
the students ate out last night	los estudiantes cenaron fuera anoche, los estudiantes salieron a cenar anoche, los estudiantes comieron fuera anoche, los estudiantes salieron a comer anoche	cenar fuera, salir a cenar, comer fuera, salir a comer
the old car eats up petrol	el coche viejo chupa gasolina, el coche viejo devora gasolina, el coche viejo traga gasolina	chupar, devorar, tragar
the hungry boy ate up his dinner	el chico hambriento se comió la cena, el chico hambriento acabó la cena, el chico hambriento disfrutó la cena, 	comer se, acabar, disfrutar
the boy egged on his team	el chico animó a su equipo	animar a
the crew embarked on Friday   phrasal verb?	la tripulación embarcó el viernes, la tripulación se embarcó el viernes	embarcar, embarcar se
the scientists embarked on a new project	los científicos se embarcaron en un nuevo proyecto, los científicos se lanzaron a un nuevo proyecto	embarcar se en, lanzar se a
the man embarked on a new challenge	el hombre se aventuró en un nuevo reto	aventurar se
the woman emptied out the drawer 	la mujer vació el cajón	vaciar
the park emptied out at nightfall	el parque se vació al anochecer	vaciar se
the drunk man emptied out the wine bottle	el borracho se terminó la botella de vino, el borracho acabó la botella de vino, el borracho vació la botella de vino	terminar se, acabar, vaciar
the argument ended in violence  borrar	la discusión desembocó en violencia	desembocarrminar en 
the concert ended off the weekend’s activities	el concierto puso fin a las actividades del fin de semana	poner fin a
the backpacker ended up in India	el mochilero acabó en la India, el mochilero terminó en la India, el mochilero llegó a la India, 	acabar en, terminar en, llegar a
the athletes ended up exhausted	los atletas terminaron agotados, los atletas acabaron agotados	terminar, acabar  
the man ended up with his ex-wife	el hombre terminó con su exesposa	terminar con
the woman ended up with first prize	la mujer se quedó con el primer premio	quedar se con
the man engaged in DIY	el hombre se dedicó al bricolaje, el hombre hizo bricolaje	dedicar se a, hacer
the woman entered into charity work	la mujer se involucró en trabajo social, la mujer participó en trabajo social	involucrar se en, participar en
French citizenship entitles people to vote	la ciudadanía francesa autoriza a la gente a votar, la ciudadanía francesa da derecho a la gente a votar	autorizar a, dar derecho a
the two tests evened up the standard	las dos pruebas igualaron el nivel, las dos pruebas nivelaron el nivel	igualar, nivelar
the football team’s results evened up	se igualaron los resultados del equipo del fútbol, se nivelaron los resultados del equipo del fútbol, 	igualar se, nivelar se
the violator faced up to two years of prison	el infractor se enfrentó a dos años de prisión, el infractor hizo frente a dos años de prisión	enfrentar se a, hacer frente a, enfrentar a
the man faced up to his past	el hombre afrontó su pasado, el hombre se enfrentó a su pasado	afrontar, enfrentar a
the price of the hotel factors in breakfast	la tarifa del hotel incluye el desayuno	incluir  
this disagreement factored in his decision	este desacuerdo tuvo en cuenta su decisión, este desacuerdo consideró su decisión	tener en cuenta, considerar
daylight faded away	la luz del día se difuminó, la luz del día se atenuó, la luz del día palideció, la luz del día se disipó, la luz del día se desvaneció, la luz del día se esfumó, la luz del día desapareció, la luz del día se perdió, la luz del día se desdibujó, 	difuminar se,atenuar se, palidecer, disipar se, desvanecer se, esfumar se, desaparecer, perder se, desdibujar se
the students fell about laughing	los estudiantes se partieron de risa, los estudiantes se murieron de risa	partir se de risa, morir se de risa
cheap shoes fall apart quicky	los zapatos baratos se desarman rápidamente, los zapatos baratos se deshacen rápidamente, los zapatos baratos se rompen rápidamente, los zapatos baratos se quiebran rápidamente	desarmar se, deshacer se, romper se, quebrar se 
the victim fell apart	la víctima se derrumbó, la víctima se desmoronó	derrumbar se, desmoronar se
regional unemployment fell away last year	el desempleo regional disminuyó el año pasado, el desempleo regional decreció el año pasado, el desempleo regional menguó el año pasado, el desempleo regional decayó el año pasado, 	disminuir, decrecer, menguar, decaer
the man’s worries fell away	las preocupaciones del hombre se disiparon, las preocupaciones del hombre desaparecieron 	disipar se, desaparecer
the students fell back on their teacher	los estudiantes se apoyaron en su profesor, los estudiantes recurrieron a su profesor	apoyar se en, recurrir a  
the boy fell back on his parents’ money	el chico echó mano del dinero de sus padres, el chico recurrió al dinero de sus padres	echar mano de, recurrir a 
the army fell back 	el ejercito se retiró, el ejercito retrocedió 	retirar se, retroceder
the slowest runners fell behind	los corredores más lentos se atrasaron, los corredores más lentos se retrasaron, los corredores más lentos se quedaron atrás, los corredores más lentos se rezagaron	atrasar se, retrasar se, quedar se atrás, rezagar se
the old man fell down	el anciano se cayó	caer se  
the building fell down	el edificio se derrumbó, el edificio cayó, el edificio se hundió, el edificio se vino abajo	colapsar, derrumbar se, caer, hundir se, venir se abajo
the government fell down	el gobierno falló, el gobierno fracasó	fallar, fracasar
the man fell for his co-worker	el hombre se coló por su compañera de trabajo, el hombre se murió por su compañera de trabajo	colar se por, morir se por
the boy fell for the joke	el chico se creyó la broma	creer se
the woman fell in love	la mujer se enamoró	enamorar se
the woman fell in love with her boyfriend	la mujer se enamoró de su novio	enamorar se de
the boy fell in with a bad crowd	el chico se juntó con gente mala	juntar se con
the students fell in with the teacher´s plan	los estudiantes aceptaron el plan del profesor	aceptar
the soldiers fell in line	los soldados formaron filas	formar
the old roof fell in	el techo viejo colapsó, el techo viejo se derrumbó, el techo viejo se cayó	colapsar, derrumbar se, caer se
the book falls into this category	el libro entra en esta categoría, el libro encaja en esta categoría, el libro cae en esta categoría	entrar en, encajar en, caer en
the dog fell into the hole 	el perro cayó en el agujero, el perro se cayó en el agujero	caer en, caer se en
my button fell off	mi botón cayó, mi botón se cayó, mi botón se desprendió, mi botón se despegó	caer, caer se, desprender se, despegar se,
the mirror fell off the wall	el espejo se cayó de la pared, el espejo se despegó de la pared	caer se de, despegar se de
the cushion fell off the couch	el cojín se deslizó del sofá	deslizar se de
the two men fell out	los dos hombres se pelearon, los dos hombres riñeron	pelear se, reñir
the soldiers fell out	los soldados rompieron filas	romper filas
the boy fell out of bed	el chico se cayó de la cama	caer se de  
your cousin fell over the stone	tu primo tropezó con la piedra	tropezar con
the liberal party’s plans fell through after the elections	los planes del partido liberal fracasaron después de las elecciones, los planes del partido liberal se vinieron abajo después de las elecciones, los planes del partido liberal quedaron en nada después de las elecciones, los planes del partido liberal cayeron después de las elecciones	fracasar, venir se abajo, quedar en nada, caer
my father felt for the victim	mi padre compadeció a la víctima, mi padre sintió lástima por la víctima	compadecer a, sentir lástima por
the man felt for the light switch	el hombre tanteó el interruptor 	tantear
the girl feels for her best friend	la chica quiere a su mejor amiga	querer a
the sick man felt up to the party	el enfermo se sintió con ánimos para la fiesta, el enfermo se sintió con fuerzas para la fiesta, el enfermo tuvo ganas de fiesta	sentir se con ánimos para, sentir se con fuerzas para, tener ganas de
the soldiers fought back	los soldados se resistieron, los soldados contraatacaron, los soldados se defendieron	resistir se, contraatacar, defendir se
the soldier fought off kamikaze attacks	el soldado luchó contra ataques kamikazes, el soldado combatió ataques kamikazes, el soldado se defendió de ataques kamikazes, el soldado repelió ataques kamikazes, el soldado ahuyentó ataques kamikazes	luchar contra, combatir, defender se de, repeler, ahuyentar
the man didn´t figure on the additional problems	el hombre no contó con los problemas adicionales 	contar con
the man didn’t figure on going to the party	el hombre no esperaba asistir a la fiesta	esperar
the teacher figured out the problem	el profesor resolvió el problema, el profesor solucionó el problema	resolver, solucionar
the police figured out the secret code	la policía descifró el código secreto, la policía averiguó el código secreto, la policía determinó el código secreto, la policía descubrió el código secreto	descifrar, averiguar, determinar, descubrir
the woman filled in for her colleague	la mujer sustituyó a su compañero, la mujer reemplazó a su compañero	sustituir a, reemplazar a
the student filled in a questionnaire	el estudiante rellenó un cuestionario, el estudiante completó un cuestionario	rellenar, completar
the boy filled in the teacher’s place	el chico suplantó el lugar del profesor	suplantar
the man filled the woman in 	el hombre puso al corriente a la mujer	poner al corriente a
the child filled out last year	el niño engordó el año pasado	engordar
a woman filled out the ballot	una mujer rellenó la papeleta	rellenar
the man filled up his glass	el hombre llenó su copa	llenar   
the prison was filled up with political prisoners	la cárcel se llenó de presos políticos, la cárcel se llenó con presos políticos, la cárcel estaba lleno de presos políticos	llenar se de, llenar se con, estar lleno de 
the man filled up his glass with vodka	el hombre llenó su copa de vodka, el hombre llenó su copa con vodka	llenar de, llenar con
the man found out their weakness	el hombre descubrió su debilidad, el hombre se dio cuenta de su debilidad	descubrir, dar se cuenta de
the teacher found something out	el profesor averiguó algo, el profesor se enteró de algo, el profesor descubrió algo	averiguar, enterar se de, descubrir
the player finished off the season	el jugador terminó la temporada, el jugador acabó la temporada, el jugador completó la temporada	terminar, acabar, completar
the killer finished the man off	el asesino eliminó al hombre, el asesino liquidó al hombre, el asesino remató al hombre	eliminar a, liquidar a, rematar a
the student finished up the project	el estudiante terminó el proyecto, el estudiante acabó el proyecto	terminar, acabar  
the project finished up	el proyecto se terminó, el proyecto se acabó	terminar se, acabar se
the girl finished with her boyfriend	la chica cortó con su novio, la chica acabó con su novio, la chica terminó con su novio, 	cortar con, acabar con, terminar con
my cousin fired up the car   	mi primo encendió el coche, mi primo arrancó el coche, mi primo puso el coche en marcha	encender, arrancar, poner en marcha
the coach fired up the team	el entrenador animó al equipo, el entrenador avivó al equipo, el entrenador enfervorizó al equipo	animar a, avivar a, enfervorizar a
manufacturing fired up the country´s economy	la producción avivó la economía del país, la producción hizo despegar la economía del país, la producción animó la economía del país	avivar, hacer despegar, enfervorizar se, animar
the terrorist fired upon the police officer	el terrorista disparó contra el policía, el terrorista disparó al policía	disparar contra, disparar a
the new student fit in well	el estudiante nuevo se adaptó bien, el estudiante nuevo encajó bien, el estudiante nuevo congenió bien	adaptar se, encajar, congeniar
the hotel fit in one more guest	el hotel acomodó a un huésped más	acomodar a
the new boy fits in well with the other students	el chico nuevo encajó bien con los otros alumnos	encajar con
the clues of the crime fit together perfectly	las pistas del crimen encajaron perfectamente, las pistas del crimen se adaptaron perfectamente	encajar, adaptar se
the family fixed up the old house	la familia arregló la casa antigua, la familia restauró la casa antigua, la familia reparó la casa antigua	arreglar, restaurar, reparar
the man fixed up his friends	el hombre juntó a sus amigos, el hombre emparejó a sus amigos	juntar a, emparejar a
her enthusiasm will fizzle out	su entusiasmo se apagará, su entusiasmo decaerá, su entusiasmo caerá, su entusiasmo quedará en nada, su entusiasmo se morirá	apagar se, decaer, caer, quedar en nada, morir se
the dispute flared up	la disputa se reavivó, la disputa se encendió, la disputa se agudizó, la disputa estalló	reavivar se, encender se, agudizar se, estallar
the patient’s arthritis flared up	la artritis del paciente brotó,  la artritis del paciente se exacerbó,  la artritis del paciente se inflamó	brotar, exacerbar se, inflamar se
the man´s temper flared up	el mal carácter del hombre estalló, el mal carácter del hombre saltó	estallar, saltar
the woman flicked through the magazine	la mujer hojeó la revista	hojear
the refugees flooded in to the country	los refugiados inundaron el país, los refugiados invadieron el país, los refugiados llegaron masivamente al país, los refugiados afluyeron al país	inundar, invadir, llegar masivamente, afluir 
complaints flooded in	las quejas llovieron, las quejas se agolparon, las quejas afloraron	llover, agolpar se, aflorar
the boy fobbed off his mother	el chico engatusó a su madre	engatusar a
the girl focused on her studies	la chica se dedicó a sus estudios, la chica se centró en sus estudios	dedicar se a, centrar se en
the boy never follows through	el chico nunca acaba, el chico nunca termina, el chico nunca cumple	acabar, terminar, cumplir
the woman followed through with her plans	la mujer terminó con sus planes, la mujer acabó con sus planes	terminar con, acabar con
the doctor followed up the test results	el medico investigó los resultados de la prueba, el medico estudió los resultados de la prueba	investigar, estudiar
the police officer followed up the lead	el policía siguió la pista 	seguir
the student fooled around	el estudiante hizo el tonto	hacer el tonto
the couple fooled around	la pareja echó un polvo	echar un polvo
the politician forged ahead	el político siguió adelante	seguir adelante
the council forged ahead with their plans	el consejo siguió adelante con sus planes	seguir adelante con
the robbery freaked out the neighbourhood	el atraco asustó al barrio, el atraco dio miedo al barrio	asustar a, dar miedo a
the boy freaked out	el chico flipó	flipar
the spider freaked the man out	la araña dio miedo al hombre, la araña asustó al hombre	dar miedo a, asustar a
the man freaked out about the attack	el hombre se calentó por el ataque	calentar se por
the new arrangement of the room frees up some space	la nueva disposición de la habitación libera algún espacio, la nueva disposición de la habitación deja libre algún espacio	liberar, dejar libre
the new time table frees up the worker	el nuevo horario libera al empleado	liberar a
the man freshened up	el hombre se refrescó, el hombre se lavó	refrescar se, lavar se
the woman freshened up the room	la mujer refrescó la habitación, la mujer lavó la habitación, la mujer aireó la habitación, la mujer ventiló la habitación, la mujer oreó la habitación	refrescar, lavar, airear, ventilar, orear
the loud noise frightened away the dog	el ruido alto espantó al perro	espantar a
the black death frightened off many people	la peste negra asustó a muchos ciudadanos, la peste negra espantó a muchos ciudadanos, la peste negra ahuyentó a muchos ciudadanos	asustar a, espantar a, ahuyentar a
people frown upon laziness	la gente desaprueba la pereza	desaprobar
the attic functions as an office	el ático hace las veces de despacho	hacer las veces de
the mother fussed over her son	la madre agobiaba a su hijo	agobiar a
the boy fussed over silly things	el chico se preocupaba por tonterías, el chico  se alborotaba por tonterías, el chico se impacientaba por tonterías	preocupar se por, alborotar se por, impacientar se por
the students gathered around the teacher	los estudiantes se agruparon alrededor del profesor	agrupar se alrededor de
the soldier got about two kilometres	el soldado se desplazó dos kilómetros, el soldado se movió dos kilómetros, el soldado viajó dos kilómetros	desplazar se, mover se, viajar
the director got across his point of view	el director transmitió su punto de vista, el director hizo entender su punto de vista, el director expresó su punto de vista	transmitir, hacer entender, expresar
the best employees always get ahead	los mejores empleados siempre progresan, los mejores empleados siempre salen adelante	progresar, salir adelante
the boy got ahead of his friend	el chico adelantó a su amigo, el chico ganó a su amigo	adelantar a, ganar a
the girls get along with her sister	la chica se lleva bien con su hermana	llevar se bien con
the children get along	los niños se llevan bien	llevar se bien  
the plans got along with everyone´s help	los planes progresaron con la ayuda de todos, los planes prosperaron con la ayuda de todos 	progresar con, prosperar con
the children got along without the teacher’s help	los niños se apañaron sin la ayuda del profesor	apañar se sin
the student finally got around to his homework	el estudiante finalmente encontró tiempo para sus deberes	encontrar tiempo para
the tourists got around without help	los turistas se movieron sin ayuda, los turistas se desplazaron sin ayuda, los turistas viajaron sin ayuda	mover se, desplazar se, viajar
the students got around the teacher’s rules	los estudiantes evitaron las reglas del profesor, los estudiantes sortearon las reglas del profesor	evitar, sortear
the rumour got around quickly	el rumor corrió rápido, el rumor se difundió rápido	correr, difundir se
the man got at his point quickly	el hombre insinuó su tema rápido, el hombre quiso decir su tema rápido	insinuar, querer decir
the bully got at the boy	el acosador se metió con el chico	meter se con
the politician got at the judge	el político se hizo con el juez, el político sobornó al juez	hacer se con, sobornar a
the criminal got away with the crime	el criminal salió impune del delito, el criminal se zafó del delito, el criminal se libró del delito	salir impune de, zafar se de, librar se de
the prisoner got away	el preso se escapó, el preso se fugó, el preso se escabulló, el preso huyó	escapar se, fugar se, escabullir se, huir
the woman got back at eight o’clock	la mujer volvió a las ocho, la mujer regresó a las ocho	volver, regresar
the woman got back her book on Saturday	la meujer recuperó su libro el sabado	recuperar
the child got back at his friends	el niño se vengó de sus amigos	vengar se de
the man got back into yoga again	el hombre recuperó el interés por el yoga otra vez	recuperar el interés por
the politician got behind the initiative	el político respaldó la iniciativa, el político apoyó la iniciativa 	respaldar, apoyar
the man got by last month	el hombre se las arregló el mes pasado, el hombre salió adelante el mes pasado	arreglar se las, salir adelante
the woman gets by in French	la mujer se apañó en francés	apañar se
the student got down to his work	el estudiante se puso a trabajar	poner se a
the woman got down 	la mujer bajó, la mujer se bajó, la mujer se apeó 	bajar, bajar se, apear se
the exam results got the boy down	las notas del examen desanimaron al chico, las notas del examen deprimieron al chico	desanimar a, deprimir a
the woman got in	la mujer entró, la mujer se metió, la mujer subió	entrar, meter se, subir
the man got in the car	el hombre entró en el coche, el hombre subió al coche, el hombre se metió en el coche	entrar en, subir a, meter se en
the children got into the car	los niños se metieron en el coche, los niños subieron al coche	meter se en, subir a
the boy got into punk music	el chico se enganchó a la música punk, el chico se interesó por la música punk	enganchar se a, interesar se por
the criminal got off with just a warning	el criminal zafó y solo le dieron un aviso 	zafar
the children got off with the sweets	los niños afanaron los caramelos, los niños birlaron los caramelos, 	afanar, birlar
the passenger got off	el pasajero se bajó, el pasajero se apeó	bajar se, apear se
the man got off quickly	el hombre se corrió rápidamente	correr se
the employee got on to his boss	el empleado consultó con su jefe, el empleado consultó a su jefe	consultar con, consultar a
the student got on to his next project	el estudiante prosiguió con el siguiente trabajo, el estudiante siguió con el siguiente trabajo	proseguir con, seguir con
the passenger got on the train	el pasajero se montó en el tren, el pasajero subió al tren, el pasajero se subió al tren	montar se en, subir a, subir se a
the man got on in life	el hombre triunfó en la vida, el hombre fue alguien en la vida	triunfar, ser alguien
the boys get on well together	los niños se llevan bien juntos	llevar se bien  
the prisoner got out of jail	el preso se libró de la cárcel, el preso escapó de la cárcel, el preso huyó de la cárcel, el preso salió de la cárcel	librar se de, escapar de, huir de, salir de
the students got out of homework	los estudiantes eludieron los deberes, los estudiantes se zafaron de los deberes, los estudiantes evadieron los deberes	eludir, zafar se de, evadir
we got out before lunch	escapamos antes de comer, salimos antes de comer, huimos antes de comer	escapar, salir, huir
the man got over the flu quickly	el hombre se recuperó de la gripe pronto, el hombre mejoró de la gripe pronto, el hombre superó la gripe pronto	recuperar se, mejorar, superar
the man got over his ex girlfriend quickly	el hombre se olvidó de su exnovia rápidamente	olvidar se de
the girl got over the bad news	la chica aceptó las malas noticias, la chica creyó las malas noticias	aceptar, creer
the student got round to his homework 	el estudiante encontró tiempo para sus deberes	encontrar tiempo para
the child got round his mother	el niño convenció a su mamá, el niño persuadió a su mamá, el niño ganó a su mamá	convencer a, persuadir a, ganar a
the country got through the civil war	el país superó la guerra civil, el país sobrevivió a la guerra civil	superar, sobrevivir a
the man got through to his wife	el hombre localizó a su mujer	localizar a
the family got together	la familia se reunió, la familia se juntó, la familia se vio	reunir se, juntar se, ver se
the girls got her things together	las chicas juntaron sus cosas, la chicas recogieron sus cosas	juntar, recoger
the employees got together	los empleados se reunieron, los empleados se juntaron	reunir se, juntar se 
the workers got up early	los trabajadores se levantaron temprano	levantar se
the mother got the children up	la madre despertó a los niños	despertar a
the boy finally got the courage up 	el chico finalmente reunió el valor, el chico finalmente juntó el valor	reunir, juntar
the boy gave away all his money	el chico donó todo su dinero	donar
the child gave away his hiding place	el niño reveló su escondite, el niño confesó su escondite, el niño descubrió su escondite, el niño desveló su escondite	revelar, confesar, descubrir, desvelar
the shop gave away free magazines	la tienda entregó revistas gratis, la tienda distribuyó revistas gratis, la tienda regaló revistas gratis, la tienda repartió revistas gratis	entregar, distribuir, regalar, repartir
the millionaire gives a lot back to his community	el millonario devuelve mucho a su barrio	devolver  
the French army gave in	el ejercito francés se rindió	rendir se
the woman gave in to sleep	la mujer se rindió al sueño, la mujer sucumbió al sueño	rendir se a, sucumbir a
the government gave in	el gobierno cedió 	ceder
the patient gave in to more tests	el paciente se sometió a más pruebas	someter se a
the bonfire gave off a lot of heat	la hoguera emitió mucho calor, la hoguera despidió mucho calor, la hoguera desprendió mucho calor	emitir, despedir, desprender
the house gives onto the beach	la casa da a la playa	dar a
the sun gives out heat and light	el sol da calor y luz, el sol emite calor y luz	dar, emitir
the teacher gave out the books	el profesor repartió los libros, el profesor distribuyó los libros	repartir, distribuir
the man’s heart gave out	el corazón del hombre falló	fallar
the man’s motivation gave out	la motivación del hombre falló, la motivación del hombre se acabó, la motivación del hombre se agotó	fallar, acabar se, agotar se
give over fighting	deja de discutir	dejar de
the man gave up on his sister	el hombre abandonó a su hermana	abandonar  a
the man gave up on diets	el hombre desistió de los regímenes 	desistir de
the man gave up meat	el hombre abandonó la carne, el hombre dejó la carne, el hombre renunció a la carne	abandonar, dejar, renunciar a
the politician gave up his seat	el político cedió su puesto	ceder
the tired boy gave up	el niño cansado desistió 	desistir
the girl goes about quietly everyday	la chica se maneja tranquilamente todos los días, la chica se conduce tranquilamente todos los días, la chica se comporta tranquilamente todos los días	comportar se, conducir se, manejar se
the man goes about from town to town	el hombre vaga de un pueblo a otro	vagar
the child went about his homework	el niño se puso con sus deberes, el niño llevó a cabo sus deberes, el niño hizo sus deberes, el niño se dedicó a sus deberes	poner se con, llevar a cabo, hacer, dedicar se a
the police went after the criminal	la policía fue a por el criminal, la policía persiguió al criminal, la policía siguió al criminal, la policía fue tras del criminal	ir a por, perseguir a, seguir a, ir tras de
the politician went against his party	el político se opuso a su partido	oponer se a
the country went ahead with elections	el país siguió con las elecciones, el país siguió adelante con las elecciones 	seguir con, seguir adelante con
the boy went ahead	el chico avanzó 	avanzar  
the man went along with the decision	el hombre aceptó la decisión, el hombre consintió con la decisión	aceptar, consentir con
the employee went along with the agreement	el empleado estuvo de acuerdo con el trato	estar se acuerdo con
the plans went along well	los planes fueron bien	ir  
the girl went along to the party	la chica pasó por la fiesta	pasar por
the wheels go around quickly	las ruedas giran rápidamente, las ruedas ruedan rápidamente	girar, rodar
the train goes around the lake	el tren rodea el lago	rodear
enough food went around the party	alcanzó la comida para la fiesta	alcanzar
the flu went around the office	la gripe circuló por el despacho	circular por
a rumour went around the school	un rumor corrió por el colegio	correr por
the man went away yeasterday	el hombre se marchó ayer, el hombre se fue ayer	marchar se, ir se
the girl went back on her promise	la chica rompió su promesa, la chica no cumplió su promesa	romper, no cumplir
the man went back 	el hombre regresó, el hombre volvió	regresar, volver
the clocks went back yesterday	retrasaron los relojes ayer	retrasar
my father’s memories go back a long way	Los recuerdos de mi padre se remontan mucho tiempo atrás	remontar se
the boy went back to the party	el chico volvió a la fiesta, el chico regresó a la fiesta	volver a, regresar a
the song goes back to the sixties	la canción se remontaba a los años sesenta	remontar se a
the traveller went beyond the border	el viajero fue más allá de la frontera	ir más allá de
time goes by quickly	el tiempo se va rápido, el tiempo pasa rápido	ir se, pasar
the hiker went by the map	el senderista siguió el mapa	seguir
the traveller went by plane	el viajero fue en avión 	ir en
the soldiers passed by the village	los soldados pasaron por el pueblo	pasar por
the child went down with the flu	el niño pilló la gripe, el niño cogió la gripe	pillar, coger
the child went down with the flu   borrar	el niño cogió la gripe	coger
the woman went down the mountain	la mujer bajó la montaña, la mujer descendió la montaña	bajar, descender
commodity prices went down 	los precios de las materias primas disminuyeron	disminuir  
the woman went for the black dress	la mujer eligió el vestido negro, la mujer se decantó por el vestido negro, la mujer se decidió por el vestido negro	elegir, decantar se por, decidir se por
the children went for a swim	los niños fueron a nadar	ir a
the man went for a book	el hombre fue a por un libro	ir a por
the house went for one million euros0	la casa se vendió por un millón de euros, la casa se vendió a un millón de euros	vender se a, vender se por
the woman went in	la mujer entró  	entrar  
the man goes into the police next week	el hombre se apunta a la policía la semana que viene, el hombre quiere entrar en la policía la semana que viene	apuntar se a, querer entrar
the teacher went into the school	el profesor entró en el colegio 	entrar en  
the woman went into engineering	la mujer se metió en ingeniería 	meter se en  
the man went off with his wife	 el hombre se marchó con su mujer, el hombre salió con su mujer, el hombre se fue con su mujer	marchar se con, salir con, ir se con 
the alarm went off early	la alarma sonó temprano	sonar
fresh food goes off quickly	los alimentos frescos se pasan rápidamente, los alimentos frescos se estropean rápidamente	pasar se, estropear se
the party went off with a bang	la fiesta triunfó	triunfar  
the girl went off alone	la chica se fue sola, la chica se marchó sola	ir se, marchar se
the boy went off his girlfriend	el chico se desenamoró de su novia	desenamorar se de
the depressed man went on	el hombre deprimido siguió, el hombre deprimido perduró, el hombre deprimido continuó, el hombre deprimido aguantó	seguir, perdurar, continuar, aguantar
the teenagers went out last night	los adolescentes salieron anoche	salir  
the electricity went out	la electricidad se apagó	apagar se  
the football player went over to the new team	el futbolista se pasó al nuevo equipo, el futbolista cambió al nuevo equipo, el futbolista pasó al nuevo equipo	pasar se a, cambiar a, pasar a
the teacher went over her notes	la profesora repasó sus apuntes, la profesora revisó sus apuntes	repasar, revisar
the government went through with the new law	el gobierno llevó a cabo la nueva ley, el gobierno siguió adelante con la nueva ley	llevar a cabo, seguir adelante con
the traveller went through airport security	el viajero cruzó la seguridad aeroportuaria, el viajero pasó por la seguridad aeroportuaria 	cruzar, pasar por
the child went through terrible things	el niño sufrió mucho, el niño soportó mucho	sufrir, soportar
the traffic went through the new tunnel	el tráfico atravesó el túnel nuevo	atravesar 
the human resources manager went through all the CVs	el gerente de recursos humanos revisó todos los currículum, el gerente de recursos humanos repasó todos los currículum	revisar, repasar
the animals went through all the food in a week	los animales agotaron la comida en una semana, los animales acabaron con la comida en una semana, los animales se quedaron sin comida en una semana, 	agotar, acabar con, quedar se sin
that shirt and that tie go together	esa camisa y esa corbata hacen juego, esa camisa y esa corbata combinan bien	hacer juego, combinar bien
the wardrobe, bed and bedside table go together	el armario, la cama y la mesilla hacen juego	hacer juego
the ship went under	el barco se hundió	hundir se
the business went under	la empresa fracasó	fracasar 
the rate of inflation went up last year	la tasa de inflación aumentó el año pasado, la tasa de inflación subió el año pasado	aumentar, subir
the building went up quickly	el edificio se erigió rápidamente, el edificio se construyó rápidamente, el edificio se levantó rápidamente	erigir se, construir se, levantar se
the lift went up two floors	el ascensor ascendió dos plantas	ascender
the burning building went up quickly	el edificio en llamas se incendió rápidamente, el edificio en llamas explotó rápidamente, el edificio en llamas estalló rápidamente	encender se, explotar, estallar
the child went with his parents	el niño acompañó a sus padres, el niño fue con sus padres, el niño salió con sus padres	acompañar a, ir con, salir con
the man’s socks go with his shoes	los calcetines del hombre combinan con sus zapatos	combinar con
the man went without alcohol last month	el hombre pasó sin alcohol el mes pasado, el hombre prescindió del alcohol el mes pasado	pasar sin, prescindir de
the couple grew apart	la pareja se alejó, la pareja se distanció, la pareja se separó	alegar se, distanciar se, separar se
teenagers generally grow away from their parents	los adolescentes se distancian de sus padres generalmente	distanciar se de
the tumour grew back quickly	el tumor volvió a crecer, el tumor volvió a salir	volver a salir, volver a crecer
caterpillars grow into butterflies	las orugas se convierten en mariposas, las orugas se transforman en mariposas	convertir se en, transformar se en
the boy grew into a handsome man	el chico se convirtió en un hombre guapo	convertir se en
the child grew into his uniform	el niño pudo usar el uniforme	poder usar
the film grew out of the book	la película nació del libro, la película surgió del libro	nacer de, surgir de
the boy grew out of cartoons	el niño perdió el interés por los dibujos animados	perder el interés por
the woman grew out of her small hometown	la mujer se fue de su pueblo pequeño natal	ir se de
the child grew up	el niño creció, el niño se hizo mayor, el niño maduró	crecer, hacer se mayor, madurar
the company hammered out all the problems	la empresa lidió con todos los problemas	lidiar con
the teacher handed round the books	la profesora repartió los libros, la profesora pasó los libros, la profesora entregó los libros	repartir, pasar, entregar
the man handed back the watch	el hombre devolvió el reloj	devolver  
the man handed down his valuable collection	el hombre legó su colección valiosa	legar
the student handed in the assignment	el estudiante entregó el trabajo, el estudiante presentó el trabajo	entregar, presentar
the man handed himself in 	el hombre se rindió, el hombre se entregó	rendir se, entregar se
the employee handed in his notice	el empleado notificó su dimisión 	notificar 
the children hand on their old toys to an orphanage	los niños pasan sus juguetes viejos a un orfanato	pasar
the teacher handed out the exams	el profesor repartió los exámenes, el profesor distribuyó los exámenes	repartir, distribuir
the criminal handed over the weapon	el criminal dio el arma, el criminal entregó el arma, el criminal cedió el arma	dar, entregar, ceder
the man hung around 	el hombre esperó	esperar
the teenagers hung around the park	los adolescentes pasearon por el parque, los adolescentes merodearon por el parque, los adolescentes estuvieron dando vueltas por el parque	pasear por, merodear por, estar dando vueltas
the shy child hung back	el niño tímido se quedó atrás	quedar se atrás
the distracted child hung back	el niño distraído vaciló	vacilar
the diamond earrings hung down	los pendientes de diamantes colgaban	colgar
the flowers hung down in autumn	las flores se marchitaron en otoño 	marchitar se
the student hung in all year	el estudiante perseveró todo el año, el estudiante no se rindió en todo el año	perseverar, no rendir se
the audience hung on every word	el público puso atención a cada palabra	poner atención a
the dog’s tongue hung out	la lengua del perro colgaba	colgar
the girl hung out with her friends	la chica se juntó con sus amigas, la chica salió con sus amigos	juntar se con, salir
the clouds hung over the sea	las nubes flotaban sobre el mar, los nubes se adueñaron del mar	flotar sobre, adueñar se de
the woman hung up the telephone	la mujer colgó el teléfono	colgar
delays hung up the project deadline	los retrasos pararon la fecha límite del proyecto, los retrasos detuvieron la fecha límite del proyecto	parar, detener
the couple had it out yesterday	la pareja trató un asunto ayer	tratar un asunto
the traveller headed for Europe	el viajero se dirigió a Europa, el viajero tiró para Europa, el viajero apuntó hacia Europa	dirigir se a, tirar para, apuntar hacia
the family headed off	la familia salió, la familia se fue	salir, ir se
the police headed off the traffic	la policía desvió el tráfico 	desviar
the rescue party headed off	el equipo de rescate partió, el equipo de rescate se marchó, el equipo de rescate se fue	partir, marchar se, ir se
the manager heads up the new project	el director lidera el nuevo proyecto	liderar
the student heard about the new school principal	el estudiante se enteró del nuevo director del colegio	enterar se de
the woman heard from her brother yesterday	la mujer tuvo noticias de su hermano ayer	tener noticias de
the president heard of the tragic news	el presidente se enteró de la mala noticia, el presidente supo de la mala noticia 	enterar se de, saber de
the woman heard her friend out	la mujer escuchó a su amiga	escuchar a
the cook heated up the sauce	el cocinero calentó la salsa	calentar  
the discussion heated up quickly	el debate se calentó rápidamente, el debate se animó rápidamente, el debate se caldeó rápidamente 	calentar se, animar se, caldear se
the man helped his aunt along	el hombre ayudó a su tía	ayudar a
the man helped his elderly parents out	el hombre ayudó a sus padres mayores	ayudar a
the soldiers hemmed in the civilians	los soldados acorralaron a los civiles, los soldados asediaron a los civiles, los soldados cercaron a los civiles	acorralar a, asediar a, cercar a
the woman hid away the jewels	la mujer escondió las joyas	esconder
the criminal hid away	el criminal se escondió	esconder se
the child hit his classmate back	el niño devolvió el golpe a su compañero de clase	devolver el golpe a
the man hit on the beautiful woman	el hombre sedujo a la mujer guapa	seducir a
the criminals hid out in the forest	los criminales se ocultaron en el bosque, los criminales se escondieron en el bosque	ocular se, esconder se
the man holds everything against his friend	el hombre achaca todo a su amigo, el hombre reprocha todo a su amigo, el hombre recrimina todo a su amigo	achacar a, reprochar a, recriminar a
the referee held the boxers back	el árbitro contuvo a los boxeadores	contener a
the employee held back information	el empleado retuvo información	retener
the spy held eveything back	el espía se calló todo	callar se
the child held back tears	el niño reprimió las lágrimas, el niño se reprimió las lágrimas, el niño contuvo las lágrimas	reprimir, reprimir se, contener
the police officer held the criminal down	el policía sujetó al criminal	sujetar a
the patient held down food yesterday	el paciente retuvo la comida ayer	retener
the woman holds down two jobs	la mujer mantiene dos empleos, la mujer tiene dos empleos	mantener, tener
the politician held forth	el político no paró de hablar	no parar de hablar
the police held off the attackers	la policía frenó a los agresores	frenar a
the child held on to the railing	el niño se agarró a la barandilla,  el niño se aferró a la barandilla,  el niño se agarró de la barandilla,  el niño se asió a la barandilla,  el niño se asió de la barandilla	agarrar se a, aferrar se a, agarrar se de, asir se a, asir se de
hold on a minute please	espera un minuto	esperar
the man held onto his pride	el hombre conservó su orgullo, el hombre mantuvo su orgullo	conservar, mantener
the soldiers held out 	los soldados se resistieron	resistir se
the food held out	la comida duró, la comida aguantó	durar, aguantar
the man held out his hand	el hombre tendió su mano, el hombre extendió su mano	tender, extender
the government held out against the rebels	el gobierno resistió ante los rebeldes, el gobierno se resistió ante los rebeldes, el gobierno se opuso a los rebeldes	resistir ante, resistir se ante, oponer se a
the woman held out for a miracle	la mujer esperó por un milagro	esperar por
the organizers held over the film festival	los organizadores aplazaron el festival de cine, los organizadores pospusieron el festival de cine	aplazar, posponer
the beam holds up the ceiling	la viga sostiene el techo, la viga soporta el techo, la viga sujeta el techo, la viga sustenta el techo	sostener, soportar, sujetar, sustentar
the computer system holds up payments	el sistema informático demora los pagos, el sistema informático retrasa los pagos	demorar, retrasar
the stressed student held up well	el estudiante estresado aguantó bien, el estudiante estresado resistió bien	aguantar, resistir
the decision holds with current legislation	la decisión concuerda con la ley vigente, la decisión cumple con la ley vigente	concordar con, cumplir con 
the cable hooks up easily	el cable engancha fácilmente, el cable conecta fácilmente, el cable se engancha fácilmente, el cable se conecta fácilmente	enganchar se, conectar se, enganchar, conectar
the couple hooked up  	la pareja se enrollo	enrollar se
the couple hooked up last night  borrar	la pareja folló anoche	follar, enrollar se
the police hunted down the gang	la policía cazó a la banda, la policía persiguió a la banda	cazar a, perseguir a
the children hurried up	los niños se dieron prisa, los niños se apresuraron	dar se prisa, apresurar se
the teacher hurried the children up 	la profesora apuró a los niños	apurar a  
the guest imposed on his hosts	el invitado molestó a sus anfitriones 	molestar a
the extra work imposed on the employee	el trabajo extra molestó al empleado, el trabajo extra incomodó al empleado, el trabajo extra importunó al empleado	molestar a, incomodar a, importunar a
the woman improved on her Spanish	la mujer mejoró su español	mejorar
the man indulged in a massage	el hombre se permitió un masaje	permitir se
the employee insisted on a promotion	el empleado insistió en un ascenso, el empleado demandó un ascenso	insistir en, demandar
the man interfered with the woman	el hombre manoseó a la mujer, el hombre tocó a la mujer	manosear a, tocar a
the school invested in new technology	la escuela invirtió en nuevas tecnologías, la escuela apostó fuerte por nuevas tecnologías 	invertir en, apostar fuerte por
the man ironed out the suit	el hombre planchó el traje	planchar
the boss ironed out the problems	el jefe resolvió los problemas, el jefe solucionó los problemas	resolver, solucionar
the man is itching for a new opportunity	el hombre se muere por una nueva oportunidad	morir se por
the man jacked in his job	el hombre se piró del trabajo	pirar se
the man jacked off	el hombre se masturbó	masturbar se
the shops jacked up the price of water	las tiendas subieron el precio del agua, las tiendas inflaron el precio del agua	subir, inflar
the paper jammed up the photocopier	el papel obstruyó la fotocopiadora, el papel atascó la fotocopiadora, el papel bloqueó la fotocopiadora	obstruir, atascar, bloquear
the homeowners jazzed up their house	los dueños de la casa realzaron la casa	realzar
the man jerked his girlfriend around	el hombre mareó la perdiz con su novia	marear la perdiz con
the children joined in	los niños se unieron, los niños participaron, los niños se apuntaron 	unir se, participar, apuntar se
the children joined up the jigsaw	los niños juntaron el puzzle, los niños unieron el puzzle, los niños conectaron el puzzle	juntar, unir, conectar
five new members joined up to the gym	cinco nuevos miembros se apuntaron al gimnasio, cinco nuevos miembros se inscribieron en el gimnasio	apuntar se a, inscribir se en
the man joined with the team	el hombre acompañó al equipo	acompañar a
the child joined in with the games	el niño participó en los juegos, el niño se apuntó a los juegos	participar en, apuntar se a
the woman jotted down the phone number	la mujer anotó el número de teléfono, la mujer apuntó el número de teléfono	anotar, apuntar
the man jotted down the name on a page	el hombre apuntó el nombre en una hoja, el hombre anotó el nombre en una hoja	apuntar en, anotar en
the designer juiced up the project	el diseñador dio alegría al proyecto, el diseñador dio vida al proyecto	dar alegría, dar vida
the child jumbled up his words	el niño alteró sus palabras, el niño mezcló sus palabras, el niño confundió sus palabras	alterar, mezclar, confundir
the man jumbled up his things with the woman’s things	el hombre mezcló sus cosas con las cosas de la mujer	mezclar con
the diver jumped in	el buceador se tiró, el buceador se zambulló 	tirar se, zambullir se
the man jumped in the water	el hombre se metió en el agua, el hombre se sumergió en el agua	meter se en, sumergir se en
the speaker jumped in the debate	el orador se involucró en el debate	involucrar se
the child jumped into the pool	el niño se tiró a la piscina, el niño se metió en el agua	tirar se a, meter se en
the employee jumped into the new project	el empleado se involucró en el nuevo proyecto	involucrar se en
the dog jumped on the couch	el perro saltó sobre el sofá	saltar sobre
the woman jumped up	la mujer saltó	saltar  
the broken piece jutted out	la pieza rota sobresalió 	sobresalir
the broken branch jutted out from the tree	la rama rota sobresalió del árbol	sobresalir de
the mathematician kept at the equation	el matemático siguió con la ecuación, el matemático perseveró con la ecuación	seguir con, perseverar con
the dog kept away	el perro mantuvo la distancia, el perro no se acercó, el perro se mantuvo alejado	mantener la distancia, no acercar se, mantener se alejado
the man kept the money back	el hombre guardó el dinero, el hombre reservó el dinero	guardar, reservar
the policeman kept back	el policía se mantuvo lejos	mantener se lejos 
the man kept the child back	el hombre mantuvo lejos al niño	mantener lejos a
poverty kept the people down	la pobreza limitó a la gente	limitar a
the supermarket kept the prices down	el supermercado controló los precios	controlar
the police officer kept the criminal down	el policía sujetó al criminal, el policía reprimió al criminal	sujetar a, reprimir a
the man kept from smoking	el hombre se abstuvo de fumar, el hombre se contuvo de fumar, el hombre se aguantó de fumar	abstener se de, contener se de, aguantar se de
vitamins keep you from sickness	las vitaminas protegen de las enfermedades	proteger de
the president kept the country from war	el presidente alejó el país de la guerra	alejar de
the woman kept in with her neighbours	la mujer se mantuvo en contacto con sus vecinos	mantener se en contacto
the child kept the tears in	el niño contuvo las lágrimas, el niño reprimió las lágrimas, el niño se tragó las lágrimas	contener, reprimir, tragar se
the man kept off the grass	el hombre no pisó el césped 	no pisar
the woman kept off the property	la mujer no entró en la propiedad	no entrar en
the man kept on talking	el hombre siguió hablando, el hombre persistió en hablar, el hombre insistió en hablar	seguir, persistir en, insistir en
the police officer kept the public out	el policía no dejó entrar al público, el policía no dejó pasar al público	no dejar entrar a, no dejar pasar a
the old woman keeled over	la mujer mayor se desplomó, la mujer mayor desfalleció	 desplomar se, desfallecer
the man kept to the diet	el hombre siguió la dieta, el hombre se ajustó a la dieta, el hombre mantuvo la dieta	seguir, ajustar se a, mantener
the child kept to the footpath	el niño se mantuvo en la acera, el niño permaneció en la acera	mantener se en, permanecer en
the couple kept together	la pareja no se separó	no separar se
the guards kept the prisoner under watch	los guardias vigilaron al preso, los guardias mantuvieron bajo vigilancia al preso	vigilar a, mantener bajo vigilancia
the father kept up with the child	el padre mantuvo el ritmo del niño	mantener el ritmo
the politician kept up with the news	el político estuvo al tanto de las noticias	estar al tanto de
the man kept up his hobbies	el hombre mantuvo sus aficiones. el hombre siguió con sus aficiones	mantener, seguir con
the marathon runner kept up	el corredor de maratón aguantó el ritmo, el corredor de maratón mantuvo el ritmo	aguantar el ritmo, mantener el ritmo
the woman keyed in the code	la mujer tecleó el código	teclear
the student kicked against the class structure	el estudiante se opuso a la estructura de la clase	oponer se a
the manager kicked around the idea	el director propuso la idea	proponer
football season kicked off early	la temporada de fútbol arrancó pronto, la temporada de fútbol empezó pronto, la temporada de fútbol comenzó pronto, la temporada de fútbol se inauguró pronto, la temporada de fútbol se inició pronto	arrancar, empezar, comenzar, inaugurar se, iniciar se
the boy kicked over the bin	el chico pateó la papelera	patear
the teacher kicked the student out	el profesor echó al alumno, el profesor expulsó al alumno	echar a, expulsar a
the boy kidded around	el chico bromeaba, el chico correteaba	bromear, corretear
the hunter killed off the animals	el cazador exterminó a los animales, el cazador mató a los animales	exterminar a, matar a
the man kneeled down	el hombre se arrodilló	arrodillar se
the man knocked about his wife	el hombre golpeó a su mujer, el hombre pegó a su mujer, el hombre maltrató a su mujer	golpear a, pegar a, maltratar a
the employees knocked about the idea	los empleados consideraron la idea	considerar
the children knocked the boy around	los niños machacaron al niño, los niños golpearon al niño	machacar a, golpear a
the women knocked around the business idea	las mujeres debatieron la idea del negocio, las mujeres deliberaron la idea del negocio, las mujeres consideraron la idea del negocio, las mujeres discutieron la idea del negocio	debatir, deliberar, considerar, discutir
the news knocked the man back	las noticias bloquearon al hombre	bloquear a
the man knocked back the drinks	el hombre se mamó las bebidas, el hombre se bajó las bebidas	mamar se, bajar se
the house knocked the man back one million euros	la casa nueva sacó al hombre un millón de euros	sacar a
the council knocked down the building	el concejo derribó el edificio, el concejo demolió el edificio	derribar, demoler
the shop knocked down the prices	la tienda abarató los precios, la tienda recortó los precios, la tienda liquidó los precios, la tienda bajó los precios	abaratar, recortar, liquidar, bajar
the car knocked the man down	el coche atropelló al hombre	atropellar a
the child knocked down the game	el niño tiró el juego	tirar
the man knocked off his work	el hombre acabó su trabajo, el hombre terminó su trabajo	acabar, terminar
the company knocks off designer handbags	la empresa copia los bolsos de marca	copiar
the employees knocked off early	los trabajadores salieron pronto, los trabajadores se piraron pronto	salir, pirar se
the boxer knocked out his opponent	el boxeador noqueo su oponente, el boxeador tumbó su oponente 	noquear a, tumbar a
the van knocked over the the pedestrian	la furgoneta arrolló el peatón, la furgoneta atropelló el peatón	arrollar, atropellar
the child knocked over the vase	el niño volcó el jarrón, el niño tiró el jarrón, el niño tumbó el jarrón	volcar, tirar, tumbar
the student knocked together an English essay	el estudiante hizo de prisa una redacción de inglés 	hacer de prisa
the man knocked up the girl	el hombre preñó a la chica	preñar a, embarazar a
the man knocked up his girlfriend   borrar? 	el hombre preñó la mujer	preñar, preñar a, embarazar a 
the students knuckled down to work	los estudiantes se volcaron al trabajo, los estudiantes se esmeraron en el trabajo, los estudiantes se aplicaron al trabajo	volcar se a, esmerar se en, aplicar se a, poner se a
the man lashed out	el hombre atacó	atacar
the woman laughed off the crazy suggestion	la mujer se rió antes la sugerencia loca	reír se antes, reír se de
the man launched into the project	el hombre lanzó de lleno  al proyecto	lanzar se de lleno a 
the man set aside his plans	el hombre aparcó sus planes, el hombre pospuso sus planes	aparcar, posponer
the soldiers laid down their arms	los soldados se rindieron	rendir se, bajar los brazos
the government laid down the law	el gobierno estableció la ley, el gobierno puso la ley, el gobierno impuso la ley	establecer, poner, imponer
the child lay down	el niño se echó, el niño se tumbó 	echar se, tumbar se, acostar se
farmers lay in hay	los granjeros almacenan el heno	almacenar
the man laid into his brother	el hombre atacó a su hermano	atacar a
the company laid off the employees	la empresa prescindió de los empleados, la empresa despidió los empleados, la empresa echó los empleados	prescindir de, despedir a, echar
lay off your sister	no molestes a tu hermana, no fastidies a tu hermana	no molestar a, no fastidiar a
the man laid the newspaper on the table	el hombre puso el periódico sobre la mesa	poner sobre
the artist laid the paint on the canvas	el artista aplicó la pintura sobre el lienzo	aplicar sobre
the stylist laid out the clothes	el estilista compuso la ropa, el estilista dispuso la ropa, el estilista ordenó la ropa, el estilista colocó la ropa	componer, disponer, ordenar, colocar
the man laid out a lot of money 	el hombre desembolsó mucho dinero	desembolsar, dejar
the government laid out the budget	el gobierno expuso el presupuesto	exponer
the boxer laid out his opponent	el boxeador noqueo su oponente	noquear  
the committee laid over the meeting	el comité pospuso la reunión	posponer
the army laid up extra supplies	el ejercitó almacenó suministros	almacenar, colocar
the students lazed around	los alumnos holgazanearon 	holgazanear
the interview led on to a job	la entrevista llevó a un empleo, la entrevista trajo consigo un empleo, la entrevista supuso un empleo 	llevar a, traer consigo, suponer, conducir a 
intensive research led up to the breakthrough	la investigación intensiva llevó al avance	llevar a, conducir a 
the research leads up to the logical conclusion	la investigación lleva a la conclusión lógica	llevar a, conducir a 
the student learned off the rules	el estudiante aprendió de memoria las reglas	aprender de memoria
the man left his wallet behind	el hombre dejó su cartera, el hombre olvidó su cartera	dejar, olvidar
the runner left the other competitors behind	el corredor dejó los otros competidores atrás	dejar atrás
the student left the others behind	el estudiante aplastó los otros	aplastar
leave off smoking	Deja de fumar	dejar de
the contract left out the company name	el contrato omitió el nombre de la empresa, el contrato excluyó el nombre de la empresa, el contrato obvió el nombre de la empresa	omitir, excluir, obviar
the boy let his parents down	el chico decepcionó sus padres	decepcionar a
the fireman let down the ladder	el bombero tiró la escalera	tirar, bajar
the dressmaker let down the hem	la costurera alargó el dobladillo	alargar
the mechanic let down the tyres	el mecánico desinfló los neumáticos	desinflar
the child let go of the balloon	el niño soltó el globo, el niño dejó el globo	soltar, dejar
the man let in the carpenter	el hombre dejó entrar el carpintero	dejar entrar
the man let off the dogs	el hombre dejó en libertad los perros	dejar en libertad, liberar, soltar 
the man let on the secret	el hombre dijo el secreto	decir, revelar, contar
the children let out the dogs	los niños dejaron salir los perros, los niños hicieron salir los perros, los niños soltaron los perros	dejar salir, hacer salir, soltar
the guards let out the prisoners	los guardas liberaron los presos	liberar
the dressmaker let out the dress	la costurera agrandó el vestido	agrandar
the child let out the secret	el niño dijo el secreto, el niño escupió el secreto	decir, escupir, revelar
the man let out a scream		lanzar un grito, dar un grito, pegar un grito
the man let out a scream	se escapó un grito al hombre	escapar se, 
the storm let up	la tormenta paró, la tormenta aflojó	parar, aflojar
the employer levelled with the employee	el empleador se sinceró con el empleado	sincerar se con
the child lay down	el niño se acostó, el niño se tumbó, el niño se echó	acostar se, tumbar se, echar se
the man lifted up the painting	el hombre alzó el cuadro, el hombre elevó el cuadro, el hombre levantó el cuadro, el hombre subió el cuadro	alzar, elevar, levantar, subir
the woman’s face lit up	se iluminó la cara de la mujer	iluminar se
the lamp lit up the room	la lámpara iluminó la habitación	iluminar  
the woman lit up a cigarette	la mujer encendió un cigarrillo	encender
the stressed man lightened up	el hombre estresado se relajó 	relajar se
the man lined up the paintings	el hombre alineó los cuadros	alinear
the teacher lined up the new events	el profesor arregló los eventos nuevos, el profesor programó los eventos nuevos	arreglar, programar, organizar
the boy never lived down his fall	el chico nunca superó la vergüenza de su caída	superar la vergüenza de, superar
the girl lives for her family	la chica vive para su familia	vivir para
the man lives off his parents	el hombre vive de sus padres	vivir de
the man lives on his savings	el hombre se mantiene con sus ahorros, el hombre se sostiene con sus ahorros, el hombre vive de sus ahorros	mantener se, sostener se, vivir de
the dead man´s memory lives on	el recuerdo del muerto perdura, el recuerdo del muerto pervive, el recuerdo del muerto sobrevive	perdurar, pervivir, sobrevivir
the sisters live together	las hermanas conviven	convivir, vivir juntos
the concert lived up to the man´s expectations	el concierto igualó las expectaciones del hombre	igualar
the man lived with his wife	el hombre convive con su mujer, el hombre vive con su mujer	convivir con, vivir con
the woman lived with her decision	la mujer sobrellevó su decisión	sobrellevar
the police locked up the criminal	la policía enchironó el criminal, la policía encerró el criminal 	enchironar, encerrar
the woman longed for help	la mujer ansió ayuda, la mujer deseó ayuda	ansiar, desear, anhelar
the man logged in	el hombre inició la sesión, el hombre abrió la sesión	iniciar la sesión, abrir la sesión
the woman logged on	la mujer se conectó, la mujer inició la sesión	conectar se, iniciar la sesión
the worker logged onto the website	el empleado entró en la página web, la mujer accedió a la página web	entrar en, acceder a
the man logged off	el hombre cerró la sesión, el hombre finalizó la sesión	cerrar la sesión, finalizar la sesión, desconectarse
the woman logged out	la mujer se deslogueó, la mujer cerró la sesión	desloguear, cerrar la sesión, desconectarse
the secretary looked after the paperwork	la secretaria veló por el papeleo, la secretaria se ocupó del papeleo, la secretaria se preocupó por el papeleo	velar por, ocupar se de, preocupar se por, encargar se de
a doctor looks after the sick	un médico cuida los enfermos, un médico cuida de los enfermos	cuidar, cuidar de, cuidar a
the marketing department looks after advertising	el departamento de marketing atiende la publicidad, el departamento de marketing vigila la publicidad	atender, vigilar, ocupar se de 
the undergraduate looked ahead 	el estudiante universitario miró adelante	mirar adelante, mirar hacia adelante
the man looked at the painting	el hombre miró el cuadro	mirar
the woman looked back	la mujer miró atrás	mirar atrás, mirar hacia atrás
the old man looked back	el hombre mayor rememoró	rememorar
the old woman looked back on her past	el mujer mayor recordó su pasado	recordar
the mountain climber looked down on the village	el alpinista oteó el pueblo, el alpinista vislumbró el pueblo	otear, vislumbrar
the man looked down on immigrants	el hombre menospreció los inmigrantes, el hombre despreció los inmigrantes	menospreciar, despreciar
the student looked for the book	el estudiante esperó el libro, el estudiante buscó el libro	esperar, buscar
the man looked forward to the visit	el hombre ansió la visita, el hombre anheló la visita	ansiar, anhelar
the woman looked in on the church	la mujer pasó por la iglesia	pasar por
the police looked into the complaint	la policía investigó la denuncia, la policía revisó la denuncia, la policía miró la denuncia	investigar, revisar, mirar, examinar
the scientists looked into the findings	los científicos estudiaron los resultados, los científicos evaluaron los resultados, los científicos vieron los resultados	estudiar, evaluar, ver, examinar, investigar
the boy looks like his mother	el chico se parece a su madre	parecer se a
the woman looked on the painting	la mujer miró el cuadro, la mujer observó el cuadro, la mujer consideró el cuadro	mirar, observar, considerar
the house looks onto the lake	la casa da al lago	dar a  
the man looked out for dangers	el hombre vigiló los peligros, el hombre estuvo atento a los peligros	vigilar, estar atento a
the girl looked out for her younger brother	la chica cuidó su hermano pequeño, la chica se ocupó de su hermano pequeño	cuidar, ocupar se de, cuidar a
the student looked over his essay	el estudiante inspeccionó su redacción, el estudiante repasó su redacción, el estudiante miró por encima su redacción	inspeccionar, repasar, mirar por encima
the teacher looked round the room	el profesor miro alrededor de la habitación	mirar alrededor de
the detective looked round the crime scene	el agente de policía registró el lugar del delito, el agente de policía reconoció el lugar del delito, el agente de policía chequeó el lugar del delito	registrar, reconocer, chequear
the child looked through the window	el niño miró por la ventana	mirar por
the librarian looked through the books	el bibliotecario buscó entre los libros, el bibliotecario revisó los libros, el bibliotecario registró entre los libros, el bibliotecario ojeó entre los libros	buscar entre, revisar, registrar entre, ojear
the employee looked to his boss	el empleado se volvió hacia su jefe, el empleado miró a su jefe, el empleado recurrió a su jefe	volver se hacia, mirar a, recurrir a
the woman looked to find answers	la mujer buscó las respuestas	buscar  
the students looked up to their teacher	los estudiantes admiraron su profesora, los estudiantes respetaron su profesora, los estudiantes admiraron a su profesora	admirar, respetar, admirar a
the man looked up the best restaurant	el hombre buscó el mejor restaurante	buscar  
the man´s life looked up	la vida del hombre mejoró	mejorar
the students lost out	los estudiantes salieron perdiendo	salir perdiendo, perder
the company mailed out the samples	la empresa despachó las muestras	despachar, enviar, enviar por correo
the student majored in law	el estudiante se especializó en derecho	especializar se en
the girls made for the city	las chicas se dirigieron hacia la ciudad	dirigir se hacia
chocolate makes for happiness	el chocolate conduce a la felicidad, el chocolate da lugar a la felicidad	conducir a, dar lugar a
the director made the book into a movie	el director convirtió el libro en una película, el director transformó el libro en una película	convertir en, transformar en
the criminal made off	el delincuente escapó, el delincuente huyó	escapar, huir, escapar se
the criminal made off with the money	el delincuente se escapó con el dinero, el delincuente se robó el dinero	escapar se con, robar se 
the couple made out	la pareja se liaron	liar se
the decorator made over the house	el decorador redecoró la casa, el decorador remodeló la casa, el decorador renovó la casa, el decorador transformó la casa	redecorar, remodelar, renovar
the man made the cheque over to his son	el hombre cedió el cheque a su hijo, el hombre transfirió el cheque a su hijo, el hombre traspasó el cheque a su hijo	ceder a, transferir a, traspasar a
the boy made up for his bad behaviour	el chico compensó su comportamiento malo, el chico reparó su comportamiento malo	compensar, reparar
the park’s beauty makes up for its small size	la belleza del parque supera su tamaño pequeño	superar, compensar
the fans made up to the actress	los admiradores se congraciaron con la actriz, los admiradores halagaron a la actriz	congraciar se con, halagar a
the boyfriend made it up to his girlfriend	el novio compensó su novia	compensar  
the child made up the story	el niño inventó la historia	inventar
the girl made up her face	la chica se maquilló	maquillar se
the girl made up the sandwich	la chica preparó el sándwich	preparar, hacer
engineers make up the company	ingenieros forman la empresa, ingenieros arman la empresa, ingenieros montan la empresa, ingenieros constituyan la empresa	formar, armar, montar, constituir
the couple made up	la pareja se reconciliaron	reconciliar se
the teacher mapped out the school tour	el profesor planeó la excursión del colegio	planear, planificar
the teacher marked down the exam results	el profesor anotó las notas del examen, el profesor apuntó las notas del examen	apuntar, anotar
the shop marked down the old shoes	la tienda rebajó los zapatos viejos	rebajar
the trainer marked off the football pitch	el entrenador delimitó el campo del fútbol	delimitar
the cat marked out its territory	el gato marcó su territorio, el gato señalizó su territorio	marcar, señalizar
the employee marked up the document	el empleado marcó el documento	marcar  
the shop marked up the prices	la tienda subió los precios	subir el precio
the woman matched up her earrings	la mujer emparejó sus pendientes, la mujer hizo coincidir sus pendientes	emparejar, hacer coincidir
the man´s profile matched up the woman´s profile	el perfil del hombre y el perfil de la mujer se compararon	comparar se, coincidir
the best football player matched up to the new team	el jugador mejor compitió en el nuevo equipo, el jugador mejor rivalizó el nuevo equipo	competir en, rivalizar
the man maxed out his credit card	el hombre agotó su tarjeta de crédito, el hombre exprimió su tarjeta de crédito	agotar, exprimir, llegar al límite
the architect measured up the building	el arquitecto midió el edificio	medir
the boss measured up the employee	el jefe evaluó el empleado	evaluar
the supplies measured up	los suministros sirvieron	servir
the exam nagged away at the student	el examen preocupó el estudiante, el examen atormentó el estudiante	preocupar, atormentar
the carpenter nailed down the flooring	el carpintero clavó el suelo	clavar
the accountant nailed down the figures	el contable determinó las cifras, el contable precisó las cifras	determinar, precisar, detallar
the girl is named after the singer	la niña se llamó por el cantante	llamar se por
the scientist narrowed down the theories	el científico redujo las teorías, el científico restringió las teorías	reducir, restringir
the mouse nibbled away at the cheese	el ratón mordisqueó el queso	mordisquear
the dressmaker nipped off the extra material	la modista recogió la tela extra, la modista cogió la tela extra, la modista sacó la tela extra, la modista quitó la tela extra	recoger, coger, sacar, quitar
the boy nipped off	el chico salió, el chico fue corriendo	salir, ir corriendo
the woman nodded off	la mujer cabeceó 	cabecear
the inspector nosed around	el inspector husmeó, el inspector fisgoneó, el inspector se metió, el inspector fisgó	husmear, fisgonear, meter se, fisgar
the man objected to the fine 	el hombre objetó la multa, el hombre no estuvo de acuerdo con la multa	objetar, no estar de acuerdo con, oponer se a
the priest offered up the sacrifice	el sacerdote sacrificó el sacrificio 	sacrificar, ofrecer
the woman opened out the table	la mujer desplegó la mesa, la mujer abrió la mesa	desplegar, abrir
the sitting room opens out onto the pool	el salón da a la piscina	dar a  
the sitting room opens out to the pool	el salón se abre a la piscina	abrir se a
the sofa opens out to a bed	el sofá se despliega la cama	desplegar se
the victim opened up	la victima se abrió, la victima se sinceró	abrir se, sincerar se
the victim opened up to the psychologist	la víctima se confió al psicólogo 	confir se a
the man opened up the door	el hombre abrió la puerta	abrir  
the majority opted in favour  no me gusta la traducción	la mayoría decidieron tomar parte	decidir tomar parte
the victim passed away	la víctima se fue, la víctima murió, la víctima falleció, la víctima expiró 	ir se, morir, fallecer, expirar
the bus passed by the town	el autobus pasó por el pueblo	pasar por
the pedestrians passed by the beggar	los peatones ignoró el mendigo	ignorar
the man passed down his property	el hombre legó su pertenencias	legar
the teacher passed down good values	el profesor transmitió valores buenos	transmitir
the woman passed for her daughter	la mujer pasó por su hija	pasar por
the parade passed off	la cabalgata transcurrió	transcurrir
the man passed off as an expert	el hombre se hizo pasar por un experto	hacer se pasar por
the student passed on the book	el estudiante pasó el libro	pasar  
the man passed on his belongings	el hombre dejó sus pertenencias	dejar  
the sick child passed on the flu	el niño enfermo contagió a la gripe	contagiar a, transmitir
the boy quarreled with the teacher	el chico discutió con el profesor	discutir con, pelear se con
the fans queued up 	los aficionados hicieron cola	hacer cola
the teacher quietened down the students	la profesora acalló los estudiantes	acallar, calmar a, tranquilizar a
the singer raked in money	el cantante amasó el dinero	amasar
the people rallied around the campaign	la gente se solidarizó con la campaña	solidarizar se con
the teacher reached out to the student	el profesor contactó el estudiante, el profesor localizó el estudiante, el profesor llegó al estudiente	contactar, localizar, llegar a
the president read out the news	el presidente leyó en voz alta las noticias	leer en voz alta
the student read up on the theory	el estudiante investigó la teoría, el estudiante estudió la teoría, el estudiante se documentó la teoría, el estudiante se informó la teoría	investigar, estudiar, documentar se, informar se
the doctor referred to his notes	el medico consultó sus notas	consultar
the email refers to the problem	el email se tratá del problema, el email se refiere al problema	tratar se de, referir se a 
the students reflect on the school	los estudiantes recaen sobre el colegio	recaer sobre
the man reflected on his life	el hombre reflexiónó sobre su vida, el hombre consideró su vida	reflexionar sobre, considerar
the man reflected upon his life	el hombre reflexiónó sobre su vida	reflexionar sobre  
the woman saved up the deposit	la mujer ahorro la fianza	ahorrar
the boy saved up the chocolate	el niño guardó el chocolate, el niño acumuló el chocolate	guardar, acumular
the student screwed up the exam	el estudiante arruinó el examen, el estudiante fregó el examen, el estudiante cagó el examen, el estudiante se cargó el examen	arruinar, fregar, cagar, cargar se, joder
the employee screwed up 	el empleado la cagó, el empleado la jodió, el empleado metió la pata, 	cagar la, joder la, meter la pata
the critic scoped out the best restaurants	el crítico averiguó los restaurantes mejores	averiguar, analizar
the police sealed off the crime scene	la policía acordonó la escena del crímen	acordonar, cerrar
the employee saw about the job	el empleado pensó el trabajo, el empleado consideró el trabajo	pensar, considerar
the teacher saw about the exam	el profesor se encargó del examen	encargar se de
the tennis player saw off the opponent	el tenista corrió al oponente, el tenista despidió al openente	correr a, despedir a
the man saw off the woman	el hombre despidió a la mujer	despedir a
the woman saw through the window	la mujer vio a través de la ventana	ver a través de
the teacher saw through the excuses	la profesora caló las excusas, la profesora adivinó la intención de las excusas	calar, adivinar la intención de
the teacher saw to the student	el profesor se encargó del estudiante, el profesor se ocupó del estudiante	encargar se de, ocupar se de
the storm tailed off	la tormenta se apagó, la tormenta remitió, la tormenta fue disminuyendo	apagar se, remitir se, ir disminuyendo
the girl takes after the family	la niña se parece a la familia, la niña se asemejó a la la familia, la niña salió a la familia	aparecer se a, asemejar se a, salir a
the police took after the robbers	la policía persiguió los ladrones 	perseguir
the mechanic took apart the engine	el mecánico desmontó el motor, el mecánico desarmó el motor, el mecánico deshizo el motor	desmontar, desarmar, deshacer
the teacher took aside the student	el profesor llevó aparte al estudiante, el profesor apartó al estudiante	llevar aparte a, apartar a
the police took away the money	la policía quitó el dinero, la policía requisó el dinero, la policía confiscó el dinero 	quitar, requisar, confiscar
the man took away the animal	el hombre sacó el animal	sacar, llevar se
the woman took back the insult	la mujer retiró el insulto, la mujer se redactó del insulto	retirar, redactar se de
the tax office took back the money	Hacienda recuperó el dinero, Hacienda recobró el dinero, Hacienda reclamó el dinero	recuperar, recobrar,reclamar
the school took back the student	el colegio readmitió el estudiante	readmitir
the man took care	el hombre tuvo cuidado	tener cuidado, cuidar se
the fans urged on the tennis player	los seguidores instaron al tenista, los seguidores alentaron el tenista, los seguidores animaron el tenista	instar a, alentar, animar
the man used up the money	el hombre gastó el dinero, el hombre usó todo el dinero	gastar, usar todo, agotar
the man ushered in the president	el hombre escoltó el presidente, el hombre hizo pasar el presidente	escoltar, hacer pasar
the war ushered in the problems	la guerra marcó el comienzo de los problemas, la guerra marcó el inicio de los problemas, la guerra dio lugar a los problemas, la guerra abrió paso a los problemas	marcar el comienzo de, marcar el inició de, dar lugar a, abrir paso, iniciar
the man vegged out	el hombre holgazaneó, el hombre vagueó 	holgazanear, vaguear
the customer verged on rude	el cliente rayó en grosería , el cliente lindó con grosería	rayar con, lindar con
the candidates vied for the job	los candidatos competieron por el trabajo, los candidatos lucharon por el trabajo	competir por, luchar por
the citizens voted in the president (no me gusta la frase en inglés)	los ciudadanos eligieron por votación el presidente	elegir por votación, votar
the school vouched for the student	el colegio respondió por el alumno	responder por
the children waited around	los niños se quedaron esperando, los niños se esperaron	quedar se esperando, esperar se
the waiter waited on the customers    wait for?	el camarero atendió los clientes	atender 
the woman waited on the bus (no me gusta la traducción) wait for?	la mujer esperó el autobús	esperar  
the children waited up	los niños esperaron despiertos, los niños no se acostaron	esperar despierto, no acostar se
the man woke up	el hombre se despertó	despertar se
the man woke up the children	el hombre despertó a los niños	despertar  a
the woman woke up to the terrible news	la mujer se desayuno con las noticias terribles, la mujer se dio cuenta de las noticias terribles	desayunar se con, dar se cuenta de, despertar se con
the celebrity walked about	el famoso paseó, el famoso deambuló 	pasear, deambular 
the woman walked around	la mujer dio una vuelta	dar una vuelta
the thief walked away with the money	el ladrón se llevó el dinero, el ladrón robó el dinero	llevar se, robar, ir se con 
the woman walked away	la mujer salió, la mujer se marchó, la mujer se fue 	salir, marchar se, ir se
the man yanked on the chain	el hombre tiró de la cadena	tirar de
the child yearned for holidays	el niño deseó las vacaciones, el niño anheló las vacaciones, el niño ansió las vacaciones, el niño se murió por las vacaciones	desear, anhelar, ansiar, morir se por
the man yelled out	el hombre gritó	gritar
the teacher zeroed in on the theory	el profesor se centró en la teoría, el profesor se concentró en la teoría, el profesor se enfocó en la teoría, el profesor dirigió la atención hacia la teoría 	centrar se en, concentrar se en, enfocar se en, dirigir la atención hacia
the woman zipped up the jacket	la mujer subió el cierre de la chaqueta, la mujer abrochó la chaqueta	subir el cierre de, abrochar, abrochar se, subir la cremallera
the camera zoomed in 	la camera hizo zoom, la camera cerró el foco 	hacer zoom, cerrar el foco
the teacher zoomed in on the student	el profesor se centró en el estudiante, el profesor se concentró en el estudiante	centrar se en, concentrar se en  
